Item ID,Weight(in kg.),PricePerUnit,Quantity,Shipping Cost,ShippingRevenue,LogisticProfit,DeliveryStatus
1,136,27,100,16,60,44,FALSE
2,91,10,174,8,88,80,FALSE
3,23,29,69,7,60,53,FALSE
4,99,14,192,13,21,8,FALSE
5,104,21,147,5,62,57,FALSE
6,75,29,126,20,81,61,FALSE
7,184,23,170,1,88,87,FALSE
8,125,27,234,20,89,69,FALSE
9,181,20,153,7,28,21,FALSE
10,139,4,167,3,40,37,FALSE
11,45,8,21,14,26,12,FALSE
12,186,7,157,12,85,73,FALSE
13,192,20,44,8,77,69,FALSE
14,191,12,228,19,90,71,FALSE
15,49,13,100,1,71,70,FALSE
16,24,19,161,10,59,49,FALSE
17,182,29,79,16,94,78,FALSE
18,84,13,51,9,38,29,FALSE
19,33,13,160,10,27,17,FALSE
20,59,12,273,8,72,64,FALSE
21,47,3,36,11,55,44,FALSE
22,88,1,275,4,68,64,FALSE
23,53,22,103,19,45,26,FALSE
24,189,18,54,11,52,41,FALSE
25,26,14,102,8,92,84,FALSE
26,123,9,252,6,86,80,FALSE
27,123,28,146,7,38,31,FALSE
28,90,11,67,2,77,75,FALSE
29,137,4,290,5,33,28,FALSE
30,139,12,199,2,31,29,FALSE
31,155,12,24,7,49,42,FALSE
32,193,16,144,20,84,64,FALSE
33,85,1,44,14,100,86,FALSE
34,173,25,196,11,43,32,FALSE
35,162,3,77,6,38,32,FALSE
36,34,14,198,2,72,70,FALSE
37,95,23,60,16,22,6,FALSE
38,197,24,37,16,23,7,FALSE
39,83,16,143,8,94,86,FALSE
40,65,7,117,4,43,39,FALSE
41,118,8,82,3,86,83,FALSE
42,159,1,296,5,53,48,FALSE
43,195,22,177,6,90,84,FALSE
44,162,19,296,3,78,75,FALSE
45,177,10,69,5,90,85,FALSE
46,182,20,134,7,75,68,FALSE
47,36,1,201,10,66,56,FALSE
48,169,17,179,4,91,87,FALSE
49,197,23,44,18,83,65,FALSE
50,29,13,253,12,53,41,FALSE
51,150,6,244,4,33,29,FALSE
52,168,11,240,7,92,85,FALSE
53,181,2,36,12,34,22,FALSE
54,123,18,160,8,99,91,FALSE
55,200,8,41,7,80,73,FALSE
56,91,10,147,19,35,16,FALSE
57,94,4,242,9,59,50,FALSE
58,78,30,184,19,36,17,FALSE
59,106,19,256,15,62,47,FALSE
60,26,7,60,18,88,70,True
61,139,24,122,7,63,56,FALSE
62,164,3,250,15,96,81,FALSE
63,32,23,44,13,72,59,FALSE
64,121,26,105,6,55,49,FALSE
65,116,10,119,10,76,66,FALSE
66,72,9,160,4,29,25,FALSE
67,192,5,191,12,74,62,FALSE
68,142,27,205,17,76,59,FALSE
69,106,23,236,6,51,45,FALSE
70,50,27,54,9,87,78,True
71,103,19,157,6,88,82,FALSE
72,63,30,35,4,61,57,FALSE
73,85,20,93,18,26,8,FALSE
74,188,23,38,16,80,64,FALSE
75,147,14,25,10,96,86,FALSE
76,20,11,50,9,85,76,FALSE
77,191,25,219,9,20,11,FALSE
78,136,23,247,9,94,85,FALSE
79,105,12,55,19,75,56,FALSE
80,147,10,125,15,43,28,FALSE
81,91,16,212,14,65,51,FALSE
82,186,19,95,13,44,31,FALSE
83,43,8,82,7,84,77,True
84,115,15,171,8,24,16,FALSE
85,50,13,39,2,24,22,True
86,79,25,187,13,46,33,FALSE
87,96,6,238,16,42,26,FALSE
88,118,15,156,17,30,13,True
89,174,2,291,7,98,91,FALSE
90,101,21,247,7,72,65,FALSE
91,99,23,28,13,95,82,FALSE
92,196,15,208,15,50,35,FALSE
93,179,5,58,8,45,37,FALSE
94,75,11,58,15,36,21,FALSE
95,109,16,268,4,85,81,FALSE
96,100,7,81,14,99,85,FALSE
97,98,27,70,2,51,49,FALSE
98,43,18,216,3,22,19,True
99,109,6,196,15,43,28,True
100,81,20,252,8,65,57,FALSE
101,126,7,110,11,25,14,FALSE
102,148,29,219,19,54,35,FALSE
103,26,11,259,2,38,36,FALSE
104,145,20,59,15,73,58,FALSE
105,106,25,263,16,45,29,FALSE
106,127,13,233,4,23,19,FALSE
107,121,2,299,14,90,76,FALSE
108,136,16,241,8,67,59,FALSE
109,58,14,90,19,61,42,FALSE
110,109,8,41,7,54,47,FALSE
111,37,23,295,19,84,65,FALSE
112,141,18,244,13,37,24,FALSE
113,104,10,100,10,58,48,FALSE
114,40,15,24,18,48,30,FALSE
115,75,17,205,7,22,15,FALSE
116,70,15,84,11,82,71,FALSE
117,160,24,99,10,42,32,FALSE
118,124,14,44,4,93,89,FALSE
119,33,23,100,4,87,83,FALSE
120,161,24,125,11,64,53,FALSE
121,49,18,225,3,32,29,FALSE
122,59,10,284,3,47,44,FALSE
123,133,2,216,16,77,61,FALSE
124,21,10,224,16,83,67,FALSE
125,42,8,193,7,60,53,FALSE
126,59,1,226,2,67,65,FALSE
127,140,27,222,11,79,68,FALSE
128,140,16,103,11,52,41,FALSE
129,183,8,239,10,27,17,FALSE
130,47,1,40,4,66,62,FALSE
131,53,18,54,16,99,83,FALSE
132,28,2,143,18,44,26,FALSE
133,151,18,142,2,54,52,FALSE
134,183,14,210,20,25,5,FALSE
135,145,19,174,10,36,26,FALSE
136,110,4,193,1,80,79,FALSE
137,165,25,170,12,58,46,FALSE
138,162,4,152,11,80,69,FALSE
139,133,11,27,4,63,59,True
140,156,14,282,17,66,49,FALSE
141,31,15,252,3,55,52,FALSE
142,33,20,136,17,81,64,FALSE
143,92,26,290,11,23,12,FALSE
144,174,13,80,17,97,80,FALSE
145,190,20,72,8,63,55,FALSE
146,36,26,22,7,71,64,FALSE
147,188,15,72,16,38,22,FALSE
148,185,29,255,4,52,48,FALSE
149,42,9,132,18,80,62,FALSE
150,98,25,203,14,26,12,FALSE
151,56,2,47,15,30,15,FALSE
152,85,1,47,20,43,23,FALSE
153,146,8,164,20,84,64,FALSE
154,110,3,162,2,24,22,FALSE
155,94,3,281,11,75,64,FALSE
156,124,11,75,7,50,43,FALSE
157,28,9,260,7,51,44,FALSE
158,157,6,185,1,77,76,FALSE
159,41,13,41,20,53,33,FALSE
160,45,26,125,13,83,70,FALSE
161,181,18,47,3,94,91,FALSE
162,144,2,57,19,97,78,FALSE
163,54,27,165,20,69,49,FALSE
164,197,19,231,10,31,21,FALSE
165,177,24,271,15,30,15,FALSE
166,75,4,40,16,57,41,FALSE
167,87,19,244,2,92,90,FALSE
168,163,23,220,2,44,42,FALSE
169,87,13,130,9,80,71,FALSE
170,115,14,207,8,33,25,FALSE
171,73,1,114,4,55,51,FALSE
172,199,12,181,15,32,17,True
173,198,19,89,18,59,41,True
174,91,29,282,7,95,88,FALSE
175,157,27,157,4,34,30,FALSE
176,80,16,101,8,63,55,FALSE
177,46,9,282,13,25,12,FALSE
178,89,4,157,17,43,26,FALSE
179,130,5,196,1,39,38,FALSE
180,42,27,210,4,35,31,FALSE
181,162,2,226,6,100,94,FALSE
182,139,29,276,16,42,26,FALSE
183,175,1,99,4,86,82,FALSE
184,111,29,177,16,24,8,FALSE
185,73,27,103,19,22,3,FALSE
186,184,18,133,10,95,85,FALSE
187,86,18,182,16,33,17,FALSE
188,29,11,187,14,71,57,FALSE
189,105,5,179,9,41,32,FALSE
190,34,9,291,16,63,47,FALSE
191,63,13,129,2,74,72,FALSE
192,45,4,143,2,96,94,FALSE
193,58,4,198,8,46,38,FALSE
194,196,28,206,3,31,28,FALSE
195,184,30,296,2,84,82,FALSE
196,47,10,37,4,37,33,FALSE
197,45,17,128,1,73,72,FALSE
198,164,19,278,18,52,34,FALSE
199,36,17,182,19,20,1,FALSE
200,152,10,186,5,47,42,FALSE
201,182,20,257,13,66,53,FALSE
202,125,6,251,15,81,66,FALSE
203,185,14,246,7,38,31,FALSE
204,122,10,82,18,72,54,FALSE
205,121,2,211,11,64,53,FALSE
206,66,30,224,7,61,54,FALSE
207,35,16,23,13,96,83,FALSE
208,62,20,294,12,20,8,FALSE
209,90,2,235,15,60,45,FALSE
210,134,24,91,4,32,28,FALSE
211,79,13,117,14,76,62,FALSE
212,145,19,44,9,75,66,FALSE
213,75,27,186,20,55,35,FALSE
214,80,29,243,8,54,46,FALSE
215,70,2,213,4,75,71,FALSE
216,163,19,279,13,94,81,FALSE
217,112,30,273,18,95,77,FALSE
218,36,6,151,17,55,38,FALSE
219,127,29,264,20,30,10,FALSE
220,66,17,44,11,23,12,FALSE
221,27,19,109,2,60,58,FALSE
222,73,4,51,12,100,88,FALSE
223,93,25,34,6,52,46,FALSE
224,192,8,92,4,41,37,FALSE
225,120,22,178,11,62,51,FALSE
226,176,29,184,16,27,11,FALSE
227,34,11,258,10,92,82,FALSE
228,64,2,296,17,66,49,FALSE
229,65,17,163,15,37,22,FALSE
230,180,20,81,2,85,83,FALSE
231,189,18,152,12,85,73,FALSE
232,109,16,105,5,54,49,FALSE
233,132,26,163,18,90,72,FALSE
234,91,2,181,6,84,78,FALSE
235,149,2,82,4,66,62,FALSE
236,89,16,159,12,73,61,FALSE
237,145,9,147,3,41,38,FALSE
238,179,13,74,1,85,84,FALSE
239,131,9,212,11,92,81,FALSE
240,22,5,253,19,92,73,FALSE
241,123,10,126,20,56,36,FALSE
242,174,2,52,19,80,61,FALSE
243,50,16,106,16,78,62,FALSE
244,197,23,120,6,44,38,FALSE
245,61,6,279,6,84,78,FALSE
246,162,21,73,6,60,54,FALSE
247,106,15,135,17,38,21,FALSE
248,169,24,75,14,30,16,FALSE
249,26,10,166,19,50,31,FALSE
250,83,12,89,14,70,56,FALSE
251,63,5,96,6,76,70,FALSE
252,74,20,220,3,95,92,FALSE
253,27,12,291,3,79,76,FALSE
254,142,12,80,17,97,80,FALSE
255,108,27,215,17,82,65,FALSE
256,175,9,101,20,89,69,FALSE
257,161,28,42,15,28,13,FALSE
258,142,24,34,3,53,50,FALSE
259,46,26,99,17,39,22,FALSE
260,151,7,30,6,62,56,FALSE
261,54,29,25,13,78,65,FALSE
262,70,5,80,6,93,87,FALSE
263,81,7,229,8,37,29,FALSE
264,120,9,28,9,39,30,FALSE
265,88,27,121,15,64,49,FALSE
266,80,1,58,18,41,23,FALSE
267,191,16,234,1,37,36,FALSE
268,109,23,300,17,65,48,FALSE
269,36,30,55,3,95,92,FALSE
270,153,21,190,7,59,52,True
271,21,5,88,11,42,31,FALSE
272,30,30,165,19,96,77,FALSE
273,42,16,261,4,21,17,FALSE
274,195,27,204,20,52,32,FALSE
275,76,18,124,17,80,63,FALSE
276,139,16,283,11,42,31,FALSE
277,101,5,69,6,86,80,FALSE
278,162,16,252,14,48,34,FALSE
279,50,17,153,11,54,43,FALSE
280,36,17,43,9,31,22,FALSE
281,101,22,162,1,35,34,FALSE
282,108,20,32,14,72,58,FALSE
283,69,18,192,2,84,82,FALSE
284,126,1,276,6,80,74,FALSE
285,119,25,121,1,57,56,FALSE
286,55,12,188,18,44,26,FALSE
287,112,20,219,20,95,75,FALSE
288,77,4,257,16,88,72,FALSE
289,94,28,295,11,24,13,FALSE
290,91,2,245,11,25,14,FALSE
291,168,9,84,17,74,57,FALSE
292,58,22,145,1,20,19,FALSE
293,40,10,116,6,37,31,FALSE
294,141,25,277,1,78,77,FALSE
295,122,19,213,17,42,25,FALSE
296,56,1,166,2,29,27,FALSE
297,195,19,58,4,36,32,FALSE
298,46,20,297,8,95,87,FALSE
299,77,20,229,7,40,33,FALSE
300,155,4,139,12,57,45,FALSE
301,26,2,251,4,73,69,FALSE
302,149,12,286,19,43,24,FALSE
303,135,8,67,10,46,36,FALSE
304,113,23,185,9,27,18,FALSE
305,43,25,283,9,46,37,FALSE
306,129,8,73,18,83,65,FALSE
307,61,27,258,5,76,71,FALSE
308,142,7,255,10,84,74,FALSE
309,148,8,144,20,37,17,FALSE
310,200,19,139,6,86,80,FALSE
311,176,12,250,20,84,64,True
312,36,15,39,16,95,79,FALSE
313,48,7,137,8,62,54,FALSE
314,177,17,83,1,60,59,FALSE
315,118,18,142,14,27,13,FALSE
316,43,24,89,20,56,36,FALSE
317,162,13,98,6,83,77,FALSE
318,63,27,69,12,51,39,FALSE
319,126,6,20,4,86,82,FALSE
320,95,29,156,1,21,20,FALSE
321,98,3,171,9,87,78,FALSE
322,25,5,242,9,63,54,FALSE
323,192,26,179,6,42,36,FALSE
324,28,3,73,18,61,43,FALSE
325,122,20,114,17,54,37,FALSE
326,171,26,257,19,82,63,FALSE
327,106,19,74,5,84,79,FALSE
328,67,3,252,20,21,1,FALSE
329,146,18,25,13,30,17,FALSE
330,139,24,234,10,79,69,FALSE
331,135,3,190,12,80,68,FALSE
332,147,5,288,7,31,24,FALSE
333,82,29,238,2,85,83,FALSE
334,105,25,295,11,26,15,FALSE
335,49,1,38,1,76,75,FALSE
336,84,5,167,20,74,54,FALSE
337,149,6,145,15,45,30,FALSE
338,36,17,21,14,58,44,FALSE
339,51,28,105,2,47,45,FALSE
340,111,9,115,9,45,36,FALSE
341,99,24,254,15,93,78,FALSE
342,130,8,38,8,28,20,FALSE
343,70,19,159,15,72,57,FALSE
344,157,21,232,6,60,54,FALSE
345,124,10,98,3,52,49,FALSE
346,161,29,234,1,99,98,FALSE
347,28,23,196,10,38,28,FALSE
348,36,24,133,18,41,23,FALSE
349,151,2,194,6,53,47,FALSE
350,135,12,59,7,74,67,FALSE
351,44,12,29,1,40,39,FALSE
352,127,19,209,8,74,66,FALSE
353,72,20,185,14,90,76,FALSE
354,75,11,24,2,22,20,FALSE
355,134,6,175,9,52,43,FALSE
356,54,30,112,20,96,76,FALSE
357,176,18,96,17,66,49,FALSE
358,182,29,34,13,21,8,FALSE
359,118,16,182,17,39,22,FALSE
360,51,28,94,10,78,68,FALSE
361,63,29,170,1,66,65,FALSE
362,159,14,147,20,53,33,FALSE
363,150,21,57,11,60,49,FALSE
364,168,25,260,19,58,39,FALSE
365,129,14,64,7,62,55,FALSE
366,27,24,180,17,29,12,FALSE
367,87,17,107,8,38,30,FALSE
368,147,20,300,14,98,84,FALSE
369,148,24,34,4,86,82,FALSE
370,158,10,258,3,99,96,FALSE
371,183,26,189,17,92,75,FALSE
372,131,1,277,6,45,39,FALSE
373,161,28,51,19,57,38,FALSE
374,79,12,256,10,42,32,FALSE
375,190,28,54,10,72,62,FALSE
376,34,6,153,12,79,67,FALSE
377,136,22,62,20,71,51,FALSE
378,26,17,21,19,20,1,FALSE
379,105,29,96,2,38,36,FALSE
380,122,7,146,12,68,56,FALSE
381,193,4,258,20,98,78,FALSE
382,176,18,279,9,69,60,FALSE
383,76,28,43,1,44,43,FALSE
384,120,21,210,3,78,75,FALSE
385,50,15,262,7,40,33,FALSE
386,118,8,200,1,30,29,FALSE
387,116,8,158,11,92,81,FALSE
388,77,25,175,2,20,18,FALSE
389,168,4,51,13,58,45,FALSE
390,187,19,130,16,32,16,FALSE
391,33,15,213,20,94,74,FALSE
392,55,23,193,12,37,25,FALSE
393,145,25,220,7,37,30,FALSE
394,137,30,245,10,52,42,FALSE
395,123,23,295,10,35,25,FALSE
396,172,9,123,13,97,84,FALSE
397,146,13,62,11,81,70,FALSE
398,153,22,96,4,69,65,FALSE
399,58,6,289,6,90,84,FALSE
400,92,10,135,2,91,89,FALSE
401,118,8,81,15,90,75,FALSE
402,106,8,199,16,92,76,FALSE
403,138,12,80,18,99,81,FALSE
404,58,3,139,5,25,20,FALSE
405,186,27,177,17,85,68,FALSE
406,115,20,228,16,35,19,FALSE
407,35,24,188,6,69,63,FALSE
408,196,28,45,8,50,42,FALSE
409,106,1,270,6,97,91,FALSE
410,160,23,230,4,21,17,FALSE
411,197,6,232,14,35,21,True
412,135,22,112,7,40,33,FALSE
413,168,30,213,7,59,52,FALSE
414,127,29,131,11,87,76,True
415,146,14,233,13,89,76,FALSE
416,110,2,224,14,23,9,FALSE
417,114,10,193,17,66,49,FALSE
418,170,7,119,20,63,43,FALSE
419,110,26,205,11,70,59,FALSE
420,47,20,298,1,72,71,FALSE
421,131,11,22,19,93,74,FALSE
422,148,18,26,9,97,88,FALSE
423,157,30,80,12,52,40,FALSE
424,191,9,195,9,47,38,FALSE
425,190,18,158,4,92,88,True
426,57,16,294,17,91,74,FALSE
427,161,26,126,18,69,51,FALSE
428,112,13,249,9,64,55,FALSE
429,110,29,89,7,47,40,FALSE
430,67,28,58,14,58,44,FALSE
431,43,7,267,8,93,85,FALSE
432,175,1,209,10,94,84,FALSE
433,87,24,144,7,37,30,FALSE
434,90,13,153,14,44,30,FALSE
435,84,17,238,15,73,58,FALSE
436,57,1,171,4,91,87,FALSE
437,129,12,56,13,33,20,FALSE
438,147,12,240,6,63,57,FALSE
439,158,26,34,7,59,52,FALSE
440,102,12,57,8,51,43,FALSE
441,85,25,74,8,45,37,FALSE
442,128,15,168,13,86,73,FALSE
443,66,1,65,4,42,38,FALSE
444,141,29,188,20,88,68,FALSE
445,153,26,34,12,35,23,FALSE
446,90,22,110,11,63,52,FALSE
447,64,30,242,17,61,44,FALSE
448,119,19,137,10,28,18,FALSE
449,168,6,148,8,34,26,FALSE
450,93,11,289,5,34,29,FALSE
451,96,7,158,7,39,32,FALSE
452,39,12,98,12,86,74,FALSE
453,24,13,35,8,29,21,FALSE
454,176,20,68,14,29,15,FALSE
455,88,19,98,14,29,15,FALSE
456,50,1,210,16,81,65,FALSE
457,60,23,134,16,68,52,FALSE
458,165,17,160,5,41,36,FALSE
459,53,20,61,7,41,34,FALSE
460,102,29,299,12,79,67,FALSE
461,183,24,256,8,49,41,FALSE
462,32,5,245,17,48,31,FALSE
463,134,2,63,14,61,47,FALSE
464,38,24,83,4,57,53,FALSE
465,110,28,223,20,31,11,FALSE
466,197,21,257,3,63,60,FALSE
467,41,5,264,14,93,79,FALSE
468,102,2,140,19,53,34,FALSE
469,197,6,247,1,44,43,FALSE
470,45,3,135,2,37,35,FALSE
471,68,5,37,8,78,70,FALSE
472,198,2,49,10,53,43,FALSE
473,190,8,269,2,64,62,FALSE
474,180,26,59,5,62,57,FALSE
475,160,2,257,14,87,73,FALSE
476,173,30,141,6,66,60,FALSE
477,175,18,92,3,59,56,FALSE
478,156,7,31,7,30,23,FALSE
479,104,21,27,17,71,54,FALSE
480,106,14,119,1,84,83,FALSE
481,126,30,147,19,65,46,FALSE
482,77,16,90,17,58,41,FALSE
483,74,24,299,20,32,12,FALSE
484,39,10,260,6,64,58,FALSE
485,168,1,99,15,78,63,FALSE
486,36,20,62,8,30,22,FALSE
487,173,2,99,14,49,35,FALSE
488,150,6,243,4,29,25,FALSE
489,193,24,149,20,77,57,FALSE
490,62,29,133,12,74,62,FALSE
491,163,4,276,11,39,28,FALSE
492,85,17,236,12,90,78,FALSE
493,23,26,27,13,93,80,FALSE
494,198,17,247,1,91,90,FALSE
495,38,17,221,6,48,42,FALSE
496,42,15,110,12,36,24,FALSE
497,200,28,99,6,61,55,FALSE
498,84,17,52,14,21,7,FALSE
499,188,4,47,17,31,14,FALSE
500,66,3,217,19,45,26,FALSE
501,131,7,90,14,96,82,FALSE
502,175,28,52,11,91,80,FALSE
503,145,26,51,8,78,70,True
504,46,23,44,12,74,62,FALSE
505,144,8,150,11,37,26,FALSE
506,89,9,149,17,85,68,FALSE
507,84,20,114,5,90,85,FALSE
508,195,9,265,1,27,26,FALSE
509,183,5,145,7,43,36,FALSE
510,79,3,144,7,33,26,FALSE
511,180,23,221,13,78,65,FALSE
512,134,29,40,9,66,57,FALSE
513,143,16,152,5,25,20,FALSE
514,82,23,49,10,96,86,FALSE
515,134,11,141,4,86,82,FALSE
516,152,20,173,17,30,13,FALSE
517,99,26,284,2,81,79,FALSE
518,157,21,192,4,62,58,FALSE
519,102,11,289,8,50,42,FALSE
520,176,26,254,18,54,36,FALSE
521,172,13,111,19,63,44,FALSE
522,186,2,205,17,97,80,FALSE
523,186,28,193,17,33,16,FALSE
524,93,15,294,20,79,59,FALSE
525,147,6,208,4,87,83,FALSE
526,40,17,72,6,44,38,FALSE
527,177,19,94,15,72,57,FALSE
528,99,21,175,17,93,76,FALSE
529,130,9,170,6,29,23,FALSE
530,156,29,94,11,62,51,FALSE
531,143,7,123,7,37,30,FALSE
532,26,4,184,20,33,13,FALSE
533,167,21,205,4,62,58,FALSE
534,163,25,117,6,87,81,FALSE
535,179,1,99,8,74,66,FALSE
536,112,11,185,20,93,73,FALSE
537,128,21,262,5,81,76,FALSE
538,31,19,152,9,53,44,FALSE
539,187,6,139,20,83,63,FALSE
540,110,24,109,5,82,77,FALSE
541,72,1,102,16,60,44,FALSE
542,97,4,60,20,56,36,FALSE
543,151,20,28,13,21,8,FALSE
544,46,11,67,16,80,64,FALSE
545,162,14,240,5,83,78,FALSE
546,42,24,257,5,97,92,FALSE
547,195,15,89,6,37,31,FALSE
548,117,13,115,10,75,65,FALSE
549,190,14,293,6,22,16,FALSE
550,152,19,42,3,50,47,FALSE
551,85,13,227,9,86,77,FALSE
552,159,8,291,10,81,71,FALSE
553,51,4,222,10,96,86,FALSE
554,90,4,257,16,76,60,FALSE
555,133,2,89,12,71,59,FALSE
556,184,7,166,19,50,31,FALSE
557,70,4,227,16,20,4,FALSE
558,183,7,94,15,28,13,FALSE
559,116,28,128,14,49,35,FALSE
560,184,23,199,3,51,48,FALSE
561,186,17,110,4,33,29,FALSE
562,76,21,262,20,67,47,FALSE
563,78,6,148,13,55,42,FALSE
564,90,19,120,11,66,55,FALSE
565,49,13,277,4,29,25,FALSE
566,60,11,197,2,25,23,FALSE
567,114,26,85,9,68,59,FALSE
568,159,25,193,16,80,64,FALSE
569,52,8,162,4,85,81,FALSE
570,55,27,179,8,92,84,FALSE
571,125,5,170,1,37,36,FALSE
572,173,10,97,11,28,17,FALSE
573,109,26,283,15,83,68,FALSE
574,156,6,288,8,57,49,FALSE
575,172,18,252,13,47,34,FALSE
576,90,18,225,1,35,34,FALSE
577,56,27,280,12,79,67,FALSE
578,124,1,258,18,89,71,FALSE
579,165,2,90,3,69,66,FALSE
580,143,25,152,20,92,72,FALSE
581,46,6,242,19,75,56,FALSE
582,90,29,212,19,97,78,FALSE
583,86,26,106,5,50,45,FALSE
584,67,9,126,7,34,27,FALSE
585,100,23,46,8,58,50,FALSE
586,200,27,35,1,73,72,FALSE
587,85,28,252,10,76,66,FALSE
588,66,17,233,12,35,23,FALSE
589,114,16,256,2,74,72,FALSE
590,124,30,232,17,35,18,FALSE
591,113,2,291,3,77,74,FALSE
592,169,14,141,6,79,73,FALSE
593,147,9,128,17,27,10,FALSE
594,43,21,106,8,33,25,FALSE
595,91,22,247,7,22,15,FALSE
596,66,16,30,1,65,64,True
597,81,21,291,16,70,54,FALSE
598,106,10,290,18,70,52,FALSE
599,113,3,131,2,68,66,FALSE
600,47,8,29,1,38,37,FALSE
601,130,29,187,16,84,68,FALSE
602,145,26,46,2,69,67,FALSE
603,176,24,118,9,47,38,FALSE
604,188,4,120,16,55,39,FALSE
605,138,20,71,16,69,53,FALSE
606,98,10,183,7,24,17,FALSE
607,188,4,210,17,35,18,FALSE
608,140,9,290,6,26,20,FALSE
609,177,29,236,13,46,33,FALSE
610,117,15,131,5,39,34,FALSE
611,137,2,29,11,66,55,FALSE
612,160,15,225,8,23,15,FALSE
613,39,21,97,2,22,20,FALSE
614,197,21,76,20,79,59,FALSE
615,185,28,147,14,76,62,FALSE
616,175,14,90,14,89,75,FALSE
617,48,17,167,4,59,55,FALSE
618,177,20,41,5,50,45,FALSE
619,178,8,202,2,79,77,FALSE
620,37,21,55,1,35,34,FALSE
621,183,13,43,18,24,6,FALSE
622,148,8,42,17,24,7,FALSE
623,182,26,253,10,84,74,FALSE
624,65,9,81,10,83,73,FALSE
625,132,12,43,4,74,70,FALSE
626,115,29,103,1,68,67,FALSE
627,150,6,183,1,79,78,FALSE
628,100,4,109,10,38,28,FALSE
629,49,4,142,5,44,39,FALSE
630,172,9,148,10,37,27,FALSE
631,137,16,143,20,54,34,FALSE
632,24,16,58,4,64,60,FALSE
633,63,20,197,4,93,89,FALSE
634,150,11,59,18,99,81,FALSE
635,70,23,204,11,40,29,FALSE
636,193,23,169,8,92,84,FALSE
637,101,26,282,17,58,41,FALSE
638,61,11,175,15,43,28,FALSE
639,193,8,59,8,25,17,FALSE
640,49,29,49,18,27,9,FALSE
641,131,21,270,10,98,88,FALSE
642,144,7,241,19,58,39,FALSE
643,88,26,200,14,38,24,FALSE
644,200,9,22,8,40,32,FALSE
645,152,9,27,16,73,57,FALSE
646,44,17,101,9,67,58,FALSE
647,79,22,63,9,66,57,FALSE
648,23,28,290,13,66,53,FALSE
649,187,11,271,17,77,60,FALSE
650,47,10,249,13,20,7,FALSE
651,92,25,238,15,58,43,FALSE
652,147,25,297,7,75,68,FALSE
653,37,3,46,16,48,32,FALSE
654,42,18,285,2,48,46,FALSE
655,102,29,199,8,77,69,FALSE
656,121,21,88,19,90,71,FALSE
657,32,19,120,15,39,24,FALSE
658,123,8,177,10,84,74,FALSE
659,90,9,287,11,73,62,FALSE
660,81,17,230,9,69,60,FALSE
661,182,24,165,13,53,40,FALSE
662,158,12,80,4,100,96,FALSE
663,98,2,292,11,38,27,FALSE
664,166,27,162,18,36,18,FALSE
665,70,24,81,15,26,11,FALSE
666,111,6,185,3,98,95,FALSE
667,40,14,151,7,74,67,FALSE
668,104,8,192,16,70,54,FALSE
669,58,28,269,8,59,51,FALSE
670,27,14,145,1,68,67,FALSE
671,176,15,93,19,32,13,FALSE
672,49,18,186,4,78,74,True
673,149,7,68,6,27,21,FALSE
674,142,29,212,4,69,65,FALSE
675,174,13,167,2,80,78,FALSE
676,99,4,53,17,22,5,FALSE
677,157,29,263,7,79,72,FALSE
678,149,24,28,9,42,33,FALSE
679,81,27,270,12,45,33,FALSE
680,137,23,180,17,46,29,FALSE
681,165,4,99,5,93,88,FALSE
682,100,25,286,15,62,47,FALSE
683,25,25,238,15,47,32,FALSE
684,148,27,243,14,100,86,FALSE
685,142,28,127,19,81,62,FALSE
686,21,30,64,17,76,59,FALSE
687,22,19,29,4,71,67,FALSE
688,71,28,152,12,84,72,FALSE
689,85,10,294,19,44,25,FALSE
690,173,21,258,6,72,66,FALSE
691,196,27,208,8,60,52,FALSE
692,180,3,68,19,87,68,FALSE
693,162,21,52,6,33,27,FALSE
694,70,21,152,15,80,65,FALSE
695,66,20,159,5,72,67,FALSE
696,37,29,48,5,33,28,FALSE
697,157,20,42,19,55,36,FALSE
698,102,3,130,9,89,80,FALSE
699,101,30,132,4,90,86,FALSE
700,133,13,22,16,33,17,FALSE
701,71,1,157,17,27,10,FALSE
702,142,2,113,20,39,19,FALSE
703,110,11,124,12,24,12,FALSE
704,105,15,145,9,91,82,FALSE
705,130,7,198,18,37,19,FALSE
706,119,27,227,4,46,42,FALSE
707,153,29,213,13,28,15,FALSE
708,148,7,259,9,98,89,FALSE
709,185,7,190,6,68,62,FALSE
710,174,15,209,16,31,15,FALSE
711,170,5,89,2,53,51,FALSE
712,179,20,163,17,41,24,FALSE
713,173,17,198,5,97,92,FALSE
714,116,23,261,9,100,91,FALSE
715,93,30,218,13,23,10,FALSE
716,194,16,137,8,67,59,FALSE
717,47,26,263,4,98,94,FALSE
718,69,14,220,16,70,54,FALSE
719,200,25,27,3,52,49,FALSE
720,55,22,199,3,26,23,FALSE
721,39,17,300,2,43,41,FALSE
722,114,26,67,10,80,70,FALSE
723,24,15,261,6,82,76,FALSE
724,171,7,133,4,60,56,FALSE
725,180,16,74,19,20,1,FALSE
726,146,9,298,9,30,21,FALSE
727,154,28,198,17,24,7,FALSE
728,31,28,183,16,63,47,FALSE
729,154,19,123,5,93,88,FALSE
730,106,1,62,12,35,23,FALSE
731,103,28,95,20,91,71,FALSE
732,162,16,223,8,40,32,FALSE
733,133,5,49,5,28,23,FALSE
734,170,7,148,12,93,81,FALSE
735,165,2,45,20,99,79,FALSE
736,45,2,278,13,84,71,True
737,197,12,173,17,57,40,FALSE
738,89,23,137,5,45,40,FALSE
739,133,25,57,16,29,13,FALSE
740,167,15,101,18,86,68,FALSE
741,79,18,31,8,70,62,FALSE
742,68,29,201,17,25,8,FALSE
743,174,17,226,17,61,44,FALSE
744,34,20,181,2,87,85,FALSE
745,198,3,211,17,23,6,FALSE
746,83,12,242,19,42,23,True
747,132,19,120,20,44,24,FALSE
748,155,8,244,3,53,50,FALSE
749,51,5,224,7,80,73,FALSE
750,56,26,52,14,97,83,FALSE
751,62,18,205,11,34,23,FALSE
752,129,20,163,2,52,50,FALSE
753,174,9,158,2,75,73,FALSE
754,124,23,89,19,41,22,FALSE
755,156,18,39,6,69,63,FALSE
756,58,14,68,17,46,29,FALSE
757,34,14,143,12,99,87,FALSE
758,115,4,215,16,45,29,FALSE
759,95,17,179,20,26,6,FALSE
760,34,30,278,6,42,36,FALSE
761,160,25,69,16,23,7,FALSE
762,125,26,263,3,27,24,FALSE
763,191,2,288,7,98,91,True
764,67,2,188,9,75,66,FALSE
765,149,7,154,6,100,94,FALSE
766,79,26,82,10,71,61,FALSE
767,70,18,187,19,23,4,FALSE
768,93,11,141,2,25,23,FALSE
769,197,18,237,3,37,34,FALSE
770,58,10,60,16,86,70,FALSE
771,87,17,168,4,70,66,True
772,61,7,120,19,81,62,FALSE
773,61,2,78,13,40,27,FALSE
774,168,24,254,7,78,71,FALSE
775,174,17,267,20,58,38,FALSE
776,39,9,53,5,40,35,FALSE
777,33,4,44,9,30,21,FALSE
778,56,24,98,13,89,76,FALSE
779,86,7,227,20,24,4,FALSE
780,52,3,248,11,54,43,FALSE
781,27,3,144,16,90,74,FALSE
782,73,28,287,5,40,35,FALSE
783,31,15,270,11,54,43,FALSE
784,194,8,139,12,49,37,FALSE
785,199,29,164,16,37,21,FALSE
786,85,22,97,11,37,26,FALSE
787,29,11,180,20,60,40,FALSE
788,26,25,106,3,23,20,FALSE
789,95,16,53,2,62,60,FALSE
790,144,26,173,1,86,85,FALSE
791,118,12,231,2,57,55,FALSE
792,131,3,85,8,40,32,FALSE
793,130,25,116,5,32,27,FALSE
794,151,28,24,13,76,63,FALSE
795,41,10,170,1,40,39,FALSE
796,88,28,250,6,64,58,FALSE
797,131,18,138,10,50,40,FALSE
798,135,19,120,12,99,87,FALSE
799,137,20,64,14,92,78,FALSE
800,180,13,213,2,22,20,FALSE
801,158,25,123,18,99,81,True
802,48,23,198,20,55,35,FALSE
803,145,8,59,12,27,15,FALSE
804,70,1,199,1,87,86,FALSE
805,175,27,269,4,49,45,FALSE
806,78,12,40,1,22,21,FALSE
807,57,18,179,5,89,84,FALSE
808,168,29,172,8,32,24,FALSE
809,62,17,263,15,78,63,FALSE
810,57,4,249,13,100,87,FALSE
811,88,27,250,18,71,53,FALSE
812,175,7,128,3,58,55,FALSE
813,99,3,59,6,40,34,FALSE
814,96,20,219,6,72,66,FALSE
815,128,18,226,11,35,24,FALSE
816,143,3,38,11,57,46,FALSE
817,181,8,112,9,60,51,FALSE
818,87,18,271,14,85,71,FALSE
819,144,22,278,14,61,47,FALSE
820,81,10,65,20,59,39,FALSE
821,134,24,80,12,48,36,FALSE
822,185,25,217,6,71,65,FALSE
823,72,13,265,9,20,11,FALSE
824,86,26,262,12,64,52,FALSE
825,45,28,155,9,78,69,FALSE
826,182,6,255,20,97,77,FALSE
827,131,9,196,14,77,63,FALSE
828,157,25,202,12,76,64,FALSE
829,85,30,230,13,84,71,FALSE
830,129,21,128,9,51,42,FALSE
831,171,11,271,4,64,60,FALSE
832,26,5,47,10,53,43,FALSE
833,69,21,141,20,74,54,FALSE
834,171,21,160,5,36,31,FALSE
835,24,6,21,14,43,29,FALSE
836,154,28,140,3,83,80,FALSE
837,139,22,123,15,87,72,FALSE
838,130,23,279,2,87,85,FALSE
839,193,25,185,15,66,51,FALSE
840,175,10,294,19,56,37,FALSE
841,100,12,34,9,91,82,FALSE
842,30,14,234,15,23,8,FALSE
843,29,13,167,3,54,51,FALSE
844,171,30,263,3,46,43,FALSE
845,94,9,54,20,47,27,FALSE
846,48,24,264,1,86,85,FALSE
847,81,13,209,12,59,47,FALSE
848,54,3,157,7,47,40,FALSE
849,76,3,272,13,86,73,FALSE
850,69,7,135,4,36,32,FALSE
851,162,17,229,8,71,63,FALSE
852,84,22,106,5,24,19,FALSE
853,196,9,249,14,77,63,FALSE
854,100,21,268,11,58,47,FALSE
855,36,10,37,9,95,86,FALSE
856,139,26,227,14,20,6,FALSE
857,133,11,94,13,93,80,FALSE
858,101,17,262,19,66,47,FALSE
859,171,16,24,19,47,28,FALSE
860,182,25,142,15,51,36,FALSE
861,126,8,152,10,82,72,FALSE
862,101,3,110,14,91,77,FALSE
863,40,24,246,1,59,58,FALSE
864,175,7,142,20,29,9,FALSE
865,63,2,77,11,96,85,FALSE
866,25,7,52,6,89,83,True
867,130,22,123,12,44,32,FALSE
868,147,30,36,9,24,15,FALSE
869,145,29,141,15,51,36,FALSE
870,169,16,214,1,93,92,FALSE
871,172,7,164,17,82,65,FALSE
872,133,12,100,4,69,65,FALSE
873,85,23,186,12,52,40,FALSE
874,187,19,168,15,31,16,FALSE
875,91,13,292,1,73,72,FALSE
876,150,2,206,3,21,18,FALSE
877,135,28,224,20,82,62,FALSE
878,97,19,82,1,46,45,FALSE
879,195,13,99,8,27,19,FALSE
880,70,9,132,8,38,30,FALSE
881,26,2,181,15,32,17,FALSE
882,53,10,102,6,50,44,FALSE
883,119,5,249,10,52,42,FALSE
884,27,19,150,9,42,33,FALSE
885,64,26,224,5,86,81,FALSE
886,198,26,29,6,57,51,FALSE
887,68,27,116,6,49,43,FALSE
888,32,29,287,6,22,16,FALSE
889,47,27,289,8,61,53,FALSE
890,147,9,225,4,45,41,FALSE
891,98,17,164,13,69,56,FALSE
892,184,5,259,4,46,42,FALSE
893,85,24,92,14,22,8,FALSE
894,24,1,193,4,94,90,FALSE
895,126,2,27,19,100,81,FALSE
896,169,14,223,9,51,42,FALSE
897,104,28,134,8,93,85,FALSE
898,123,9,224,3,54,51,FALSE
899,175,10,115,9,88,79,FALSE
900,137,23,143,19,21,2,FALSE
901,78,4,199,12,74,62,FALSE
902,22,4,206,15,32,17,FALSE
903,111,24,234,11,20,9,FALSE
904,128,12,92,17,98,81,FALSE
905,94,1,167,18,48,30,FALSE
906,154,12,296,19,23,4,FALSE
907,48,22,283,15,59,44,FALSE
908,49,4,47,6,52,46,FALSE
909,176,10,122,12,39,27,FALSE
910,88,8,141,15,28,13,FALSE
911,95,10,61,18,58,40,FALSE
912,141,21,213,2,76,74,FALSE
913,157,19,50,17,58,41,FALSE
914,54,5,271,18,50,32,FALSE
915,61,30,110,4,84,80,FALSE
916,160,26,213,12,82,70,FALSE
917,36,7,124,4,67,63,FALSE
918,175,14,70,2,94,92,FALSE
919,190,4,117,15,31,16,FALSE
920,77,5,189,8,68,60,FALSE
921,79,23,80,16,25,9,FALSE
922,163,28,79,7,56,49,FALSE
923,41,22,39,6,32,26,FALSE
924,129,15,133,1,81,80,FALSE
925,78,25,46,20,24,4,FALSE
926,73,19,123,6,68,62,FALSE
927,174,9,122,8,84,76,FALSE
928,39,10,135,10,31,21,FALSE
929,82,21,262,9,27,18,FALSE
930,110,5,243,16,26,10,FALSE
931,188,27,255,1,76,75,FALSE
932,172,11,266,17,61,44,FALSE
933,42,25,244,6,68,62,FALSE
934,181,11,203,15,28,13,FALSE
935,28,30,277,15,74,59,FALSE
936,162,8,40,4,59,55,FALSE
937,44,15,125,9,84,75,FALSE
938,129,24,56,15,39,24,FALSE
939,68,4,199,7,40,33,FALSE
940,104,13,170,11,21,10,FALSE
941,148,30,257,8,77,69,True
942,109,19,268,17,40,23,FALSE
943,56,5,298,5,24,19,FALSE
944,173,11,76,5,73,68,FALSE
945,65,10,256,12,50,38,FALSE
946,44,1,144,4,76,72,FALSE
947,87,21,146,14,48,34,FALSE
948,82,25,246,8,43,35,FALSE
949,123,19,272,12,65,53,FALSE
950,102,11,187,14,58,44,FALSE
951,43,7,97,8,90,82,FALSE
952,93,12,269,14,67,53,FALSE
953,64,20,52,8,33,25,True
954,153,8,165,4,63,59,FALSE
955,144,19,59,14,77,63,FALSE
956,162,5,64,3,21,18,FALSE
957,27,16,92,15,85,70,FALSE
958,40,28,232,1,21,20,FALSE
959,195,13,37,12,90,78,FALSE
960,22,19,231,6,65,59,FALSE
961,131,11,108,18,62,44,FALSE
962,106,14,191,12,26,14,FALSE
963,129,16,234,20,60,40,FALSE
964,187,16,56,2,70,68,FALSE
965,35,24,231,20,91,71,FALSE
966,191,4,227,1,64,63,FALSE
967,156,20,114,2,70,68,FALSE
968,115,3,27,17,68,51,FALSE
969,153,28,254,10,82,72,FALSE
970,117,26,25,19,48,29,FALSE
971,106,6,212,1,29,28,FALSE
972,118,24,231,3,31,28,FALSE
973,128,30,285,3,76,73,FALSE
974,196,10,227,12,25,13,FALSE
975,194,9,41,12,72,60,FALSE
976,41,27,236,6,65,59,FALSE
977,155,14,77,11,79,68,FALSE
978,139,21,91,10,21,11,FALSE
979,66,6,68,2,64,62,FALSE
980,56,16,44,12,38,26,FALSE
981,193,11,184,4,30,26,FALSE
982,186,22,68,2,51,49,FALSE
983,44,3,45,15,34,19,FALSE
984,21,29,145,16,44,28,FALSE
985,145,5,140,1,28,27,FALSE
986,162,19,255,12,54,42,FALSE
987,79,19,107,6,46,40,FALSE
988,159,27,235,6,31,25,True
989,133,18,156,11,88,77,FALSE
990,51,30,233,18,99,81,FALSE
991,135,17,251,8,65,57,FALSE
992,144,20,153,16,20,4,FALSE
993,93,11,175,11,42,31,True
994,97,6,62,12,36,24,FALSE
995,85,8,137,20,79,59,FALSE
996,158,7,225,17,72,55,FALSE
997,24,5,121,2,99,97,FALSE
998,148,14,100,11,71,60,FALSE
999,40,27,290,19,32,13,FALSE
1000,110,4,160,12,53,41,FALSE
1001,190,16,202,19,64,45,FALSE
1002,99,19,280,11,79,68,FALSE
1003,69,14,114,1,90,89,FALSE
1004,33,29,181,13,27,14,FALSE
1005,26,20,85,6,22,16,FALSE
1006,83,9,95,8,42,34,FALSE
1007,75,20,261,8,36,28,FALSE
1008,190,1,159,2,92,90,FALSE
1009,125,15,140,8,94,86,FALSE
1010,100,27,87,5,26,21,True
1011,137,10,103,3,56,53,FALSE
1012,185,14,77,12,30,18,FALSE
1013,161,23,144,20,21,1,FALSE
1014,33,17,38,4,33,29,FALSE
1015,53,28,299,20,40,20,FALSE
1016,41,21,285,13,42,29,FALSE
1017,131,6,69,11,80,69,FALSE
1018,27,12,55,2,55,53,FALSE
1019,43,19,60,1,81,80,FALSE
1020,54,16,212,9,91,82,FALSE
1021,126,23,141,5,58,53,FALSE
1022,75,10,46,20,87,67,FALSE
1023,133,4,39,3,94,91,FALSE
1024,30,10,210,18,22,4,FALSE
1025,108,12,230,14,23,9,FALSE
1026,99,2,71,2,39,37,FALSE
1027,152,4,73,10,21,11,FALSE
1028,123,3,167,5,52,47,FALSE
1029,67,30,236,11,22,11,FALSE
1030,82,22,78,11,95,84,FALSE
1031,31,11,139,11,25,14,FALSE
1032,194,18,64,16,31,15,FALSE
1033,36,6,247,8,29,21,FALSE
1034,72,3,233,12,48,36,FALSE
1035,29,28,298,7,97,90,FALSE
1036,186,1,224,17,88,71,FALSE
1037,33,8,54,7,75,68,FALSE
1038,84,26,142,19,73,54,FALSE
1039,175,13,263,2,82,80,FALSE
1040,114,16,95,3,93,90,FALSE
1041,37,19,167,20,99,79,FALSE
1042,160,20,193,6,93,87,FALSE
1043,156,16,236,13,67,54,FALSE
1044,186,30,129,5,76,71,FALSE
1045,43,11,54,1,96,95,FALSE
1046,132,14,182,2,50,48,FALSE
1047,75,30,54,15,71,56,FALSE
1048,184,30,279,6,45,39,FALSE
1049,166,30,133,18,72,54,FALSE
1050,63,25,66,3,96,93,FALSE
1051,179,3,104,2,39,37,FALSE
1052,30,9,214,15,92,77,FALSE
1053,194,8,120,2,49,47,FALSE
1054,191,22,136,19,74,55,FALSE
1055,109,30,154,16,44,28,FALSE
1056,29,24,299,5,86,81,FALSE
1057,167,17,33,8,30,22,FALSE
1058,187,1,195,18,86,68,FALSE
1059,184,20,154,9,64,55,FALSE
1060,64,18,159,5,78,73,FALSE
1061,118,6,275,7,45,38,FALSE
1062,100,6,156,17,21,4,FALSE
1063,110,26,121,9,32,23,FALSE
1064,73,11,141,9,82,73,FALSE
1065,98,2,280,20,93,73,FALSE
1066,134,23,226,17,93,76,FALSE
1067,113,19,278,14,87,73,FALSE
1068,163,4,291,1,87,86,FALSE
1069,32,10,76,18,95,77,FALSE
1070,30,5,218,1,79,78,FALSE
1071,128,24,262,16,80,64,FALSE
1072,131,13,176,9,69,60,FALSE
1073,161,15,158,4,39,35,FALSE
1074,75,8,273,8,40,32,FALSE
1075,102,24,85,13,22,9,FALSE
1076,108,27,269,3,88,85,FALSE
1077,58,13,27,14,67,53,FALSE
1078,119,1,105,14,81,67,FALSE
1079,102,29,161,4,43,39,FALSE
1080,181,13,267,5,83,78,FALSE
1081,181,7,82,4,49,45,FALSE
1082,183,4,257,8,27,19,FALSE
1083,40,12,273,10,47,37,True
1084,24,2,193,5,33,28,FALSE
1085,142,15,37,4,39,35,FALSE
1086,178,3,236,6,77,71,FALSE
1087,114,30,228,6,38,32,FALSE
1088,23,6,295,19,81,62,FALSE
1089,68,24,142,8,66,58,FALSE
1090,27,9,60,2,57,55,FALSE
1091,125,12,264,5,93,88,FALSE
1092,199,1,250,4,36,32,FALSE
1093,63,14,89,7,80,73,FALSE
1094,35,22,277,7,32,25,FALSE
1095,24,1,300,7,87,80,FALSE
1096,154,8,84,1,95,94,FALSE
1097,156,2,281,9,84,75,FALSE
1098,72,9,103,12,36,24,FALSE
1099,80,20,91,4,60,56,FALSE
1100,52,15,147,16,23,7,True
1101,140,28,241,10,82,72,FALSE
1102,59,19,58,5,87,82,FALSE
1103,90,4,84,6,44,38,FALSE
1104,128,6,137,2,100,98,FALSE
1105,141,8,250,3,28,25,FALSE
1106,35,24,56,5,38,33,FALSE
1107,161,27,252,6,90,84,FALSE
1108,195,5,199,1,29,28,FALSE
1109,47,15,213,19,87,68,FALSE
1110,175,30,161,4,64,60,FALSE
1111,181,6,98,11,87,76,FALSE
1112,75,9,193,5,31,26,FALSE
1113,112,3,47,13,31,18,FALSE
1114,135,18,216,9,81,72,True
1115,87,10,64,7,37,30,FALSE
1116,193,29,120,2,79,77,FALSE
1117,45,1,45,5,20,15,FALSE
1118,64,18,105,12,98,86,FALSE
1119,180,16,186,7,59,52,FALSE
1120,103,21,238,14,44,30,FALSE
1121,144,17,251,11,71,60,FALSE
1122,73,11,26,15,91,76,FALSE
1123,29,22,178,3,25,22,FALSE
1124,51,2,70,18,40,22,FALSE
1125,153,22,244,3,84,81,FALSE
1126,46,26,59,20,36,16,FALSE
1127,195,8,300,19,25,6,FALSE
1128,100,30,271,11,29,18,FALSE
1129,51,29,287,19,48,29,FALSE
1130,75,11,100,3,84,81,FALSE
1131,32,8,84,17,50,33,FALSE
1132,114,20,126,12,42,30,FALSE
1133,24,7,233,5,60,55,FALSE
1134,188,27,214,7,48,41,FALSE
1135,172,3,192,7,33,26,FALSE
1136,169,20,244,5,59,54,FALSE
1137,199,26,70,14,26,12,FALSE
1138,171,27,120,5,46,41,FALSE
1139,133,28,83,14,81,67,FALSE
1140,68,29,76,3,45,42,FALSE
1141,26,12,137,1,37,36,FALSE
1142,103,27,231,2,28,26,FALSE
1143,167,11,60,8,27,19,FALSE
1144,154,26,253,7,82,75,FALSE
1145,163,8,123,19,79,60,FALSE
1146,154,11,223,12,89,77,FALSE
1147,159,28,79,13,22,9,FALSE
1148,148,9,51,2,69,67,FALSE
1149,46,30,67,8,92,84,FALSE
1150,165,7,75,20,30,10,FALSE
1151,44,16,40,5,57,52,FALSE
1152,193,19,22,1,25,24,FALSE
1153,47,19,131,6,56,50,FALSE
1154,111,6,92,11,68,57,FALSE
1155,119,3,33,18,67,49,FALSE
1156,95,8,107,19,45,26,FALSE
1157,47,15,125,7,56,49,FALSE
1158,177,30,271,13,96,83,FALSE
1159,133,8,166,5,61,56,FALSE
1160,140,9,142,6,28,22,FALSE
1161,66,20,159,18,43,25,FALSE
1162,55,25,119,1,84,83,FALSE
1163,78,6,211,6,43,37,FALSE
1164,130,30,252,19,87,68,FALSE
1165,79,18,192,19,76,57,FALSE
1166,104,20,250,9,46,37,FALSE
1167,84,16,253,4,63,59,FALSE
1168,50,22,33,14,80,66,FALSE
1169,28,16,139,1,30,29,FALSE
1170,107,20,122,20,60,40,FALSE
1171,152,28,291,1,86,85,FALSE
1172,122,5,285,9,52,43,FALSE
1173,60,12,64,11,66,55,FALSE
1174,85,4,254,14,76,62,FALSE
1175,64,10,39,13,93,80,FALSE
1176,26,2,287,5,20,15,FALSE
1177,30,13,36,12,63,51,FALSE
1178,30,28,133,19,83,64,FALSE
1179,157,13,92,7,71,64,FALSE
1180,51,20,267,7,23,16,FALSE
1181,192,11,272,13,26,13,FALSE
1182,90,12,265,4,80,76,FALSE
1183,172,24,33,18,80,62,FALSE
1184,90,8,284,6,36,30,FALSE
1185,108,12,83,18,94,76,FALSE
1186,185,4,280,13,73,60,FALSE
1187,178,6,27,9,35,26,FALSE
1188,194,9,253,1,51,50,FALSE
1189,60,28,48,6,75,69,FALSE
1190,140,27,167,14,54,40,FALSE
1191,158,5,183,18,96,78,FALSE
1192,83,5,295,14,67,53,FALSE
1193,78,15,260,4,42,38,FALSE
1194,89,9,199,2,26,24,FALSE
1195,48,18,236,3,91,88,FALSE
1196,66,11,272,14,40,26,FALSE
1197,112,13,241,10,46,36,FALSE
1198,98,10,98,17,34,17,FALSE
1199,99,30,20,10,47,37,FALSE
1200,175,17,217,8,64,56,FALSE
1201,89,17,244,2,34,32,FALSE
1202,189,1,205,15,75,60,FALSE
1203,182,1,292,6,84,78,FALSE
1204,78,18,159,8,72,64,FALSE
1205,182,21,201,3,28,25,FALSE
1206,44,25,261,19,71,52,FALSE
1207,46,13,90,13,33,20,FALSE
1208,95,19,87,12,51,39,FALSE
1209,160,17,271,3,95,92,FALSE
1210,25,14,20,18,35,17,FALSE
1211,50,22,279,10,65,55,FALSE
1212,126,7,80,3,91,88,FALSE
1213,138,26,215,20,52,32,True
1214,146,30,145,16,68,52,FALSE
1215,127,8,300,10,98,88,FALSE
1216,86,9,269,17,100,83,FALSE
1217,30,3,48,17,95,78,FALSE
1218,127,15,237,17,82,65,FALSE
1219,58,24,189,1,59,58,FALSE
1220,72,23,99,20,87,67,FALSE
1221,115,21,62,13,96,83,FALSE
1222,49,16,234,7,84,77,FALSE
1223,91,21,191,1,93,92,FALSE
1224,174,16,158,15,29,14,FALSE
1225,26,2,234,12,86,74,FALSE
1226,190,15,209,2,69,67,FALSE
1227,154,20,293,4,25,21,FALSE
1228,63,7,45,14,51,37,FALSE
1229,63,21,82,8,29,21,FALSE
1230,40,8,81,15,77,62,FALSE
1231,69,29,287,1,77,76,FALSE
1232,123,30,163,17,31,14,FALSE
1233,49,12,136,3,95,92,FALSE
1234,41,1,218,6,54,48,FALSE
1235,106,14,124,12,53,41,FALSE
1236,109,3,131,15,98,83,FALSE
1237,176,3,232,7,59,52,FALSE
1238,122,15,206,19,67,48,FALSE
1239,167,19,109,13,22,9,FALSE
1240,178,3,50,5,42,37,FALSE
1241,160,5,188,13,94,81,FALSE
1242,34,28,54,12,100,88,FALSE
1243,110,23,261,16,30,14,FALSE
1244,28,15,78,3,49,46,FALSE
1245,169,28,295,9,52,43,FALSE
1246,69,13,140,19,49,30,FALSE
1247,44,24,23,19,96,77,FALSE
1248,190,3,260,18,76,58,FALSE
1249,154,20,197,2,82,80,FALSE
1250,44,23,44,3,67,64,FALSE
1251,65,11,216,8,99,91,FALSE
1252,191,28,147,9,45,36,FALSE
1253,175,11,237,6,20,14,FALSE
1254,118,29,221,16,33,17,FALSE
1255,157,26,106,6,71,65,FALSE
1256,195,29,231,19,42,23,FALSE
1257,66,7,107,8,70,62,FALSE
1258,115,13,181,6,23,17,FALSE
1259,72,1,115,3,99,96,FALSE
1260,101,23,276,8,84,76,FALSE
1261,53,17,73,9,37,28,FALSE
1262,38,25,160,12,56,44,FALSE
1263,117,6,261,7,76,69,FALSE
1264,151,6,218,14,69,55,FALSE
1265,170,25,293,17,95,78,True
1266,62,19,130,18,90,72,FALSE
1267,34,9,174,5,20,15,FALSE
1268,23,13,37,16,69,53,FALSE
1269,127,24,65,20,51,31,FALSE
1270,129,11,146,1,35,34,FALSE
1271,110,10,245,1,67,66,FALSE
1272,169,12,228,14,66,52,FALSE
1273,147,26,139,10,99,89,FALSE
1274,52,19,156,17,68,51,FALSE
1275,101,10,194,8,99,91,FALSE
1276,80,30,231,1,98,97,FALSE
1277,80,26,196,15,67,52,FALSE
1278,152,4,208,15,64,49,FALSE
1279,172,5,40,19,96,77,FALSE
1280,119,25,145,5,75,70,FALSE
1281,65,13,192,17,85,68,FALSE
1282,109,29,246,5,40,35,FALSE
1283,113,11,226,12,44,32,FALSE
1284,145,5,280,8,30,22,FALSE
1285,192,29,168,19,27,8,FALSE
1286,32,20,63,19,92,73,FALSE
1287,126,11,217,15,35,20,FALSE
1288,53,27,172,9,27,18,FALSE
1289,36,5,52,8,98,90,FALSE
1290,134,14,141,15,71,56,FALSE
1291,54,30,289,9,95,86,FALSE
1292,76,12,233,4,41,37,FALSE
1293,105,7,116,5,31,26,FALSE
1294,52,7,93,5,32,27,FALSE
1295,108,7,60,20,40,20,FALSE
1296,34,15,176,19,75,56,FALSE
1297,197,19,230,13,87,74,FALSE
1298,77,25,240,14,91,77,FALSE
1299,119,29,145,1,51,50,FALSE
1300,116,20,287,10,23,13,FALSE
1301,118,25,74,2,30,28,FALSE
1302,118,16,209,18,91,73,FALSE
1303,73,6,253,11,61,50,FALSE
1304,194,17,275,17,86,69,FALSE
1305,151,12,283,11,34,23,FALSE
1306,145,2,296,8,52,44,FALSE
1307,148,8,236,16,77,61,FALSE
1308,190,16,28,19,78,59,FALSE
1309,109,15,207,15,97,82,FALSE
1310,72,11,178,13,68,55,FALSE
1311,95,4,182,19,51,32,FALSE
1312,62,2,25,5,83,78,FALSE
1313,133,14,188,2,52,50,FALSE
1314,57,5,259,12,39,27,FALSE
1315,197,14,174,9,80,71,True
1316,166,1,272,10,74,64,FALSE
1317,87,24,246,7,32,25,FALSE
1318,187,3,299,19,22,3,FALSE
1319,129,5,164,13,93,80,FALSE
1320,57,27,63,12,75,63,FALSE
1321,65,2,218,1,64,63,FALSE
1322,24,22,23,1,50,49,FALSE
1323,99,12,219,7,81,74,FALSE
1324,101,19,30,10,70,60,FALSE
1325,98,30,34,19,87,68,FALSE
1326,98,5,234,18,65,47,True
1327,64,8,194,11,54,43,FALSE
1328,119,19,52,19,74,55,FALSE
1329,117,7,244,19,100,81,FALSE
1330,196,17,41,6,62,56,FALSE
1331,55,9,47,12,23,11,FALSE
1332,89,19,23,9,23,14,FALSE
1333,146,8,297,1,76,75,FALSE
1334,102,27,68,2,100,98,FALSE
1335,65,10,45,5,36,31,FALSE
1336,97,17,42,5,59,54,FALSE
1337,108,14,37,5,63,58,FALSE
1338,104,25,293,1,63,62,FALSE
1339,199,17,91,3,86,83,FALSE
1340,86,13,91,11,67,56,FALSE
1341,96,24,73,12,83,71,FALSE
1342,109,29,159,11,44,33,FALSE
1343,164,2,48,15,69,54,FALSE
1344,30,16,46,9,90,81,FALSE
1345,22,26,235,3,27,24,FALSE
1346,155,15,235,11,50,39,FALSE
1347,183,9,185,19,22,3,FALSE
1348,155,13,85,19,39,20,FALSE
1349,149,12,180,2,60,58,FALSE
1350,65,9,46,17,20,3,FALSE
1351,74,1,218,2,23,21,FALSE
1352,147,7,37,8,39,31,FALSE
1353,135,17,79,14,50,36,FALSE
1354,104,21,200,7,45,38,True
1355,72,11,92,7,56,49,FALSE
1356,134,26,166,9,89,80,FALSE
1357,132,23,287,6,28,22,FALSE
1358,131,30,145,12,55,43,FALSE
1359,88,5,268,6,89,83,True
1360,72,2,96,3,79,76,FALSE
1361,43,23,145,4,40,36,FALSE
1362,103,15,261,8,80,72,FALSE
1363,67,26,149,20,52,32,FALSE
1364,170,24,120,8,31,23,FALSE
1365,87,1,257,2,94,92,FALSE
1366,180,22,178,14,27,13,FALSE
1367,161,18,31,13,100,87,FALSE
1368,52,20,229,3,59,56,FALSE
1369,81,8,120,7,72,65,FALSE
1370,52,4,247,8,91,83,True
1371,79,2,22,14,95,81,FALSE
1372,140,10,211,2,30,28,FALSE
1373,137,28,186,18,68,50,FALSE
1374,60,20,173,7,59,52,FALSE
1375,91,14,140,19,100,81,FALSE
1376,171,3,298,19,78,59,FALSE
1377,143,12,23,10,22,12,FALSE
1378,55,30,173,14,35,21,FALSE
1379,191,5,111,7,40,33,FALSE
1380,193,27,238,9,100,91,FALSE
1381,25,1,125,17,66,49,FALSE
1382,106,29,87,4,72,68,FALSE
1383,183,27,115,19,74,55,FALSE
1384,80,22,278,10,28,18,FALSE
1385,45,30,94,14,26,12,FALSE
1386,145,8,135,15,35,20,FALSE
1387,50,16,96,16,91,75,FALSE
1388,182,25,20,15,54,39,FALSE
1389,21,16,241,3,45,42,FALSE
1390,164,27,94,17,91,74,FALSE
1391,152,26,293,20,63,43,FALSE
1392,21,18,23,8,45,37,FALSE
1393,153,13,299,9,20,11,FALSE
1394,186,17,181,20,42,22,FALSE
1395,137,8,144,17,65,48,FALSE
1396,119,10,77,16,38,22,FALSE
1397,67,24,266,14,94,80,FALSE
1398,161,1,266,9,63,54,FALSE
1399,67,10,121,13,79,66,FALSE
1400,136,23,24,5,99,94,FALSE
1401,157,29,177,12,64,52,FALSE
1402,187,2,203,13,43,30,FALSE
1403,125,2,250,14,37,23,FALSE
1404,62,24,257,3,67,64,FALSE
1405,196,14,292,1,61,60,FALSE
1406,190,16,144,13,91,78,FALSE
1407,109,2,249,2,46,44,FALSE
1408,31,1,231,7,33,26,FALSE
1409,73,15,105,17,73,56,FALSE
1410,45,7,234,16,54,38,FALSE
1411,109,7,282,18,38,20,FALSE
1412,22,16,277,7,40,33,FALSE
1413,106,4,192,6,29,23,FALSE
1414,173,25,140,7,49,42,FALSE
1415,139,21,202,18,90,72,FALSE
1416,21,26,234,10,41,31,FALSE
1417,159,13,63,15,49,34,FALSE
1418,132,25,178,8,50,42,FALSE
1419,173,16,284,17,94,77,FALSE
1420,22,25,57,12,86,74,FALSE
1421,111,10,146,17,34,17,FALSE
1422,56,22,93,13,86,73,FALSE
1423,105,28,87,19,76,57,FALSE
1424,118,12,290,7,96,89,FALSE
1425,126,26,221,1,56,55,FALSE
1426,187,1,89,13,88,75,FALSE
1427,180,1,82,7,31,24,FALSE
1428,83,11,34,13,55,42,FALSE
1429,153,6,267,16,88,72,FALSE
1430,138,22,145,10,51,41,FALSE
1431,188,5,209,2,66,64,FALSE
1432,125,7,151,6,55,49,FALSE
1433,38,20,124,17,84,67,FALSE
1434,29,19,163,18,30,12,FALSE
1435,67,19,146,2,25,23,True
1436,177,22,36,20,93,73,FALSE
1437,127,27,256,20,74,54,FALSE
1438,51,18,229,19,44,25,FALSE
1439,196,27,162,11,52,41,FALSE
1440,45,18,97,16,52,36,FALSE
1441,99,10,95,15,69,54,FALSE
1442,172,22,274,6,93,87,FALSE
1443,70,25,82,7,91,84,FALSE
1444,193,18,127,9,21,12,FALSE
1445,73,3,24,18,53,35,FALSE
1446,68,28,121,12,68,56,FALSE
1447,81,8,124,7,27,20,FALSE
1448,89,1,153,2,100,98,FALSE
1449,191,5,88,13,82,69,FALSE
1450,165,20,71,14,90,76,FALSE
1451,169,17,213,8,79,71,FALSE
1452,42,24,181,2,51,49,FALSE
1453,143,10,107,2,99,97,FALSE
1454,84,14,129,5,82,77,FALSE
1455,95,8,164,2,29,27,FALSE
1456,147,2,63,10,30,20,FALSE
1457,74,4,38,13,36,23,FALSE
1458,68,20,157,19,70,51,FALSE
1459,86,17,239,15,49,34,FALSE
1460,48,15,56,16,45,29,FALSE
1461,95,6,152,10,84,74,FALSE
1462,29,17,31,12,55,43,FALSE
1463,23,6,157,3,99,96,FALSE
1464,66,22,83,4,94,90,True
1465,112,10,156,5,92,87,FALSE
1466,66,17,165,5,96,91,FALSE
1467,119,19,299,3,27,24,FALSE
1468,28,14,64,14,49,35,FALSE
1469,103,15,43,7,27,20,FALSE
1470,70,25,110,11,100,89,FALSE
1471,63,28,165,5,85,80,FALSE
1472,163,24,227,8,67,59,FALSE
1473,87,7,32,17,93,76,FALSE
1474,132,25,299,20,65,45,FALSE
1475,59,5,247,8,28,20,FALSE
1476,184,2,107,7,78,71,FALSE
1477,187,11,138,11,96,85,FALSE
1478,83,18,81,1,69,68,FALSE
1479,195,27,115,14,91,77,FALSE
1480,139,6,162,20,82,62,FALSE
1481,40,14,197,1,71,70,FALSE
1482,50,18,48,1,85,84,FALSE
1483,23,11,70,13,52,39,FALSE
1484,141,29,116,17,55,38,FALSE
1485,159,8,243,3,98,95,FALSE
1486,99,19,186,2,94,92,FALSE
1487,130,13,161,15,63,48,FALSE
1488,78,29,39,11,75,64,FALSE
1489,74,16,60,9,24,15,FALSE
1490,194,6,218,9,90,81,FALSE
1491,166,7,222,3,61,58,FALSE
1492,65,22,39,1,33,32,FALSE
1493,192,25,146,19,25,6,FALSE
1494,60,18,90,19,68,49,FALSE
1495,40,13,135,5,21,16,FALSE
1496,164,14,106,7,68,61,FALSE
1497,52,9,266,20,88,68,FALSE
1498,189,23,161,11,63,52,FALSE
1499,122,13,158,11,39,28,FALSE
1500,104,15,163,6,30,24,FALSE
1501,182,2,52,6,73,67,True
1502,99,10,25,15,51,36,FALSE
1503,96,15,201,18,30,12,FALSE
1504,164,11,87,16,81,65,FALSE
1505,33,11,131,19,52,33,FALSE
1506,113,27,146,19,78,59,FALSE
1507,112,1,172,15,78,63,FALSE
1508,187,21,177,17,37,20,FALSE
1509,107,24,233,13,34,21,FALSE
1510,147,7,210,2,47,45,FALSE
1511,176,11,106,9,80,71,FALSE
1512,122,24,256,13,55,42,FALSE
1513,121,18,36,19,49,30,FALSE
1514,195,29,43,19,99,80,FALSE
1515,138,10,176,11,71,60,FALSE
1516,122,10,148,14,61,47,FALSE
1517,184,29,71,1,98,97,FALSE
1518,190,9,54,20,49,29,FALSE
1519,42,21,136,5,54,49,FALSE
1520,129,29,272,7,29,22,FALSE
1521,98,1,146,13,26,13,FALSE
1522,120,3,185,14,92,78,FALSE
1523,197,2,107,5,61,56,FALSE
1524,153,12,255,1,78,77,FALSE
1525,35,3,146,13,67,54,FALSE
1526,29,22,61,20,56,36,FALSE
1527,166,8,191,2,94,92,FALSE
1528,172,22,79,2,70,68,FALSE
1529,157,21,117,15,24,9,FALSE
1530,156,25,234,6,35,29,FALSE
1531,188,19,245,12,45,33,FALSE
1532,175,12,88,5,43,38,True
1533,103,12,116,5,48,43,FALSE
1534,180,26,200,15,94,79,True
1535,165,16,229,8,38,30,FALSE
1536,185,1,216,20,91,71,FALSE
1537,109,19,30,2,53,51,FALSE
1538,55,16,69,13,78,65,True
1539,199,2,71,13,78,65,FALSE
1540,38,28,95,18,26,8,FALSE
1541,94,4,112,5,75,70,FALSE
1542,117,24,64,15,77,62,FALSE
1543,176,6,29,11,45,34,FALSE
1544,131,18,78,10,74,64,FALSE
1545,108,26,41,15,91,76,FALSE
1546,200,23,83,17,80,63,FALSE
1547,101,1,276,16,96,80,FALSE
1548,131,1,241,18,22,4,FALSE
1549,128,8,212,2,43,41,FALSE
1550,107,29,55,5,74,69,FALSE
1551,43,24,265,3,93,90,FALSE
1552,141,10,43,15,55,40,FALSE
1553,179,23,251,5,88,83,FALSE
1554,131,17,259,9,39,30,FALSE
1555,143,11,242,13,85,72,FALSE
1556,72,16,284,2,22,20,FALSE
1557,189,6,246,7,70,63,FALSE
1558,64,23,59,19,27,8,FALSE
1559,122,15,165,5,87,82,FALSE
1560,97,15,234,10,25,15,FALSE
1561,38,14,103,4,54,50,FALSE
1562,109,21,52,13,31,18,FALSE
1563,120,5,219,14,67,53,FALSE
1564,23,27,232,2,21,19,FALSE
1565,29,20,263,10,89,79,FALSE
1566,99,9,56,10,33,23,FALSE
1567,115,15,88,10,85,75,FALSE
1568,39,3,25,9,37,28,FALSE
1569,34,23,88,18,76,58,True
1570,38,7,281,11,74,63,FALSE
1571,151,28,113,19,86,67,FALSE
1572,188,25,203,5,28,23,FALSE
1573,95,27,102,13,53,40,FALSE
1574,95,4,118,18,23,5,FALSE
1575,172,10,193,16,83,67,FALSE
1576,138,7,174,7,65,58,True
1577,89,8,147,4,54,50,FALSE
1578,31,29,199,11,32,21,FALSE
1579,199,25,37,20,94,74,FALSE
1580,52,5,75,4,25,21,FALSE
1581,108,5,234,17,91,74,FALSE
1582,199,30,148,16,68,52,FALSE
1583,59,22,35,3,25,22,FALSE
1584,95,25,43,16,26,10,FALSE
1585,75,21,214,17,25,8,FALSE
1586,120,20,76,5,28,23,FALSE
1587,193,20,277,7,63,56,FALSE
1588,44,12,254,2,65,63,FALSE
1589,126,29,214,7,80,73,FALSE
1590,159,10,56,14,41,27,FALSE
1591,176,16,244,6,93,87,FALSE
1592,43,14,77,12,44,32,FALSE
1593,56,10,238,17,80,63,FALSE
1594,50,26,73,19,47,28,FALSE
1595,136,14,98,3,86,83,FALSE
1596,37,3,150,7,23,16,FALSE
1597,73,9,132,3,40,37,FALSE
1598,56,26,25,3,49,46,FALSE
1599,115,4,277,13,51,38,FALSE
1600,194,4,156,10,97,87,FALSE
1601,120,26,218,2,67,65,FALSE
1602,174,9,281,10,63,53,FALSE
1603,176,4,190,17,30,13,FALSE
1604,185,2,42,5,24,19,FALSE
1605,134,10,139,6,48,42,FALSE
1606,87,25,291,17,84,67,FALSE
1607,103,18,41,7,64,57,FALSE
1608,126,22,226,1,68,67,FALSE
1609,119,3,254,3,58,55,FALSE
1610,145,11,122,8,47,39,FALSE
1611,100,21,158,18,81,63,FALSE
1612,35,20,272,16,53,37,FALSE
1613,79,3,214,4,79,75,True
1614,24,6,232,10,34,24,FALSE
1615,197,22,46,3,44,41,FALSE
1616,123,4,139,7,34,27,True
1617,62,27,167,2,45,43,FALSE
1618,132,25,180,5,23,18,True
1619,124,1,234,4,88,84,FALSE
1620,66,9,194,4,71,67,FALSE
1621,174,14,159,17,23,6,FALSE
1622,115,13,272,5,72,67,True
1623,121,17,170,3,61,58,FALSE
1624,101,4,169,7,59,52,FALSE
1625,93,4,233,17,43,26,FALSE
1626,78,18,295,1,57,56,FALSE
1627,21,5,159,1,53,52,FALSE
1628,47,12,241,18,48,30,FALSE
1629,44,22,155,6,24,18,FALSE
1630,130,4,61,10,95,85,FALSE
1631,153,27,275,4,39,35,FALSE
1632,96,2,137,16,23,7,FALSE
1633,186,26,192,12,55,43,FALSE
1634,183,24,216,1,54,53,FALSE
1635,152,21,37,8,40,32,FALSE
1636,94,16,125,15,75,60,FALSE
1637,33,27,56,9,44,35,FALSE
1638,50,4,234,5,64,59,FALSE
1639,54,30,72,20,28,8,FALSE
1640,96,10,170,9,88,79,True
1641,199,28,204,16,22,6,FALSE
1642,40,10,171,10,26,16,FALSE
1643,93,17,198,2,32,30,FALSE
1644,169,20,44,16,98,82,FALSE
1645,59,23,126,9,57,48,FALSE
1646,98,17,241,18,20,2,FALSE
1647,163,22,220,9,32,23,FALSE
1648,23,14,288,11,22,11,FALSE
1649,149,15,182,1,32,31,FALSE
1650,56,21,192,7,91,84,FALSE
1651,158,15,242,1,66,65,FALSE
1652,184,18,296,6,22,16,FALSE
1653,81,2,144,8,65,57,FALSE
1654,73,28,229,19,58,39,FALSE
1655,116,11,220,13,87,74,FALSE
1656,102,14,42,8,52,44,FALSE
1657,179,14,211,17,71,54,FALSE
1658,139,12,196,12,32,20,FALSE
1659,129,24,51,14,87,73,FALSE
1660,191,1,136,5,28,23,FALSE
1661,148,29,274,12,61,49,FALSE
1662,136,16,184,18,57,39,FALSE
1663,112,30,20,14,92,78,FALSE
1664,149,13,43,8,43,35,FALSE
1665,154,18,26,7,45,38,FALSE
1666,100,2,73,3,36,33,FALSE
1667,52,10,266,2,59,57,True
1668,156,28,126,6,22,16,FALSE
1669,70,17,211,15,99,84,FALSE
1670,183,8,244,3,32,29,FALSE
1671,115,26,178,5,41,36,FALSE
1672,110,16,252,10,44,34,FALSE
1673,103,25,105,1,27,26,True
1674,101,30,249,1,78,77,FALSE
1675,41,18,115,17,45,28,FALSE
1676,188,26,247,9,39,30,FALSE
1677,39,21,141,5,46,41,FALSE
1678,58,10,298,1,75,74,True
1679,185,27,55,5,38,33,FALSE
1680,88,16,127,3,86,83,FALSE
1681,58,15,258,19,49,30,FALSE
1682,78,27,137,6,96,90,FALSE
1683,48,25,56,18,28,10,FALSE
1684,81,1,123,18,91,73,FALSE
1685,157,14,157,2,21,19,True
1686,188,16,122,5,50,45,FALSE
1687,118,3,275,11,69,58,FALSE
1688,137,13,128,17,58,41,FALSE
1689,73,17,85,16,91,75,FALSE
1690,174,27,151,14,59,45,FALSE
1691,74,28,230,19,49,30,FALSE
1692,195,11,238,3,91,88,FALSE
1693,103,23,138,14,29,15,FALSE
1694,80,29,260,16,86,70,FALSE
1695,80,21,56,19,69,50,FALSE
1696,123,25,253,13,82,69,FALSE
1697,140,26,142,17,93,76,FALSE
1698,120,4,57,2,37,35,FALSE
1699,54,25,94,11,48,37,FALSE
1700,125,21,230,18,89,71,FALSE
1701,67,28,229,13,50,37,FALSE
1702,159,30,285,5,43,38,FALSE
1703,120,8,297,14,59,45,FALSE
1704,26,16,37,12,70,58,FALSE
1705,164,29,168,5,52,47,FALSE
1706,59,21,30,6,43,37,FALSE
1707,172,30,191,5,43,38,FALSE
1708,144,13,42,8,37,29,FALSE
1709,116,20,152,4,38,34,FALSE
1710,131,12,113,14,76,62,FALSE
1711,163,11,72,13,56,43,FALSE
1712,173,17,36,7,69,62,FALSE
1713,156,13,106,4,66,62,FALSE
1714,105,12,158,10,52,42,FALSE
1715,27,15,57,5,62,57,FALSE
1716,156,10,138,6,86,80,FALSE
1717,106,7,144,8,84,76,FALSE
1718,156,27,300,15,57,42,FALSE
1719,93,18,92,7,39,32,True
1720,44,1,91,5,25,20,FALSE
1721,167,9,129,6,93,87,FALSE
1722,140,25,110,12,83,71,FALSE
1723,187,9,104,20,98,78,FALSE
1724,159,9,249,16,28,12,FALSE
1725,110,19,207,13,48,35,FALSE
1726,112,28,127,16,68,52,FALSE
1727,156,18,65,2,44,42,FALSE
1728,136,24,163,13,49,36,FALSE
1729,54,27,205,13,74,61,FALSE
1730,129,23,197,15,54,39,FALSE
1731,149,20,210,10,44,34,FALSE
1732,108,7,30,11,61,50,FALSE
1733,142,1,54,2,41,39,FALSE
1734,50,6,204,10,26,16,FALSE
1735,134,30,299,19,69,50,FALSE
1736,175,20,298,9,23,14,FALSE
1737,116,30,49,2,53,51,True
1738,20,20,62,9,90,81,FALSE
1739,119,24,190,13,63,50,FALSE
1740,24,25,93,7,54,47,FALSE
1741,126,27,219,17,39,22,FALSE
1742,119,24,120,14,52,38,FALSE
1743,133,11,240,8,59,51,FALSE
1744,61,26,300,12,68,56,FALSE
1745,75,9,125,12,99,87,FALSE
1746,124,29,24,10,24,14,FALSE
1747,166,27,72,17,95,78,FALSE
1748,122,28,208,18,47,29,FALSE
1749,73,17,118,15,25,10,FALSE
1750,73,30,247,8,74,66,FALSE
1751,76,17,205,16,98,82,FALSE
1752,198,13,51,15,22,7,FALSE
1753,71,16,216,8,25,17,FALSE
1754,68,11,35,5,61,56,FALSE
1755,120,14,160,8,64,56,FALSE
1756,101,21,293,17,80,63,True
1757,61,21,125,11,78,67,FALSE
1758,166,16,67,9,77,68,FALSE
1759,125,15,277,17,69,52,True
1760,64,23,55,14,72,58,FALSE
1761,143,28,275,7,47,40,FALSE
1762,187,13,30,15,76,61,FALSE
1763,163,22,77,9,85,76,FALSE
1764,171,10,296,4,87,83,FALSE
1765,65,23,232,14,31,17,FALSE
1766,197,2,294,3,31,28,FALSE
1767,103,11,220,7,80,73,FALSE
1768,100,11,191,16,59,43,FALSE
1769,145,13,226,15,65,50,FALSE
1770,101,27,126,15,35,20,FALSE
1771,165,30,266,4,82,78,FALSE
1772,145,4,211,17,41,24,FALSE
1773,54,22,232,5,31,26,FALSE
1774,52,18,169,10,42,32,FALSE
1775,54,21,154,6,63,57,FALSE
1776,76,11,64,2,61,59,FALSE
1777,101,2,200,13,56,43,FALSE
1778,77,26,100,8,38,30,FALSE
1779,150,23,232,13,35,22,FALSE
1780,179,3,148,18,59,41,FALSE
1781,115,29,51,3,50,47,FALSE
1782,53,23,171,16,47,31,FALSE
1783,112,8,86,11,62,51,FALSE
1784,181,17,186,19,60,41,FALSE
1785,145,25,248,1,100,99,FALSE
1786,171,19,119,19,72,53,FALSE
1787,27,19,250,7,50,43,FALSE
1788,112,13,142,19,41,22,FALSE
1789,54,1,246,8,24,16,FALSE
1790,182,30,239,8,49,41,FALSE
1791,79,5,140,17,41,24,FALSE
1792,68,12,223,10,100,90,FALSE
1793,137,6,59,11,60,49,FALSE
1794,141,20,32,10,46,36,True
1795,177,19,93,18,61,43,FALSE
1796,180,22,43,5,60,55,FALSE
1797,104,13,296,15,37,22,FALSE
1798,42,6,244,10,82,72,FALSE
1799,73,19,283,8,51,43,FALSE
1800,49,6,133,12,22,10,FALSE
1801,183,15,83,6,79,73,FALSE
1802,108,8,197,5,62,57,FALSE
1803,190,7,255,14,97,83,FALSE
1804,142,13,164,4,67,63,FALSE
1805,117,15,213,8,52,44,FALSE
1806,167,26,246,6,59,53,FALSE
1807,184,2,134,14,40,26,FALSE
1808,95,14,293,18,57,39,FALSE
1809,65,30,255,14,87,73,FALSE
1810,136,24,155,17,93,76,FALSE
1811,168,3,216,18,73,55,FALSE
1812,56,3,57,3,76,73,FALSE
1813,74,21,128,20,36,16,FALSE
1814,83,27,122,2,24,22,FALSE
1815,46,15,30,16,86,70,FALSE
1816,26,22,128,8,96,88,FALSE
1817,178,2,102,7,81,74,FALSE
1818,92,12,237,16,26,10,FALSE
1819,166,19,181,2,80,78,FALSE
1820,174,12,196,6,86,80,FALSE
1821,56,29,142,13,98,85,FALSE
1822,198,10,165,6,30,24,FALSE
1823,181,22,151,3,72,69,FALSE
1824,95,28,179,15,97,82,FALSE
1825,67,29,206,6,68,62,FALSE
1826,25,21,35,19,93,74,FALSE
1827,96,28,165,3,87,84,FALSE
1828,45,7,131,18,59,41,FALSE
1829,103,18,33,1,82,81,FALSE
1830,93,9,127,8,51,43,FALSE
1831,105,12,151,2,93,91,FALSE
1832,166,5,241,11,68,57,True
1833,147,25,268,8,20,12,FALSE
1834,158,2,72,7,88,81,FALSE
1835,107,5,170,15,78,63,True
1836,180,24,267,20,58,38,FALSE
1837,182,19,125,2,41,39,FALSE
1838,20,2,146,19,74,55,FALSE
1839,46,30,140,9,98,89,FALSE
1840,59,11,56,1,87,86,FALSE
1841,97,16,38,10,57,47,FALSE
1842,120,8,195,15,41,26,FALSE
1843,59,28,242,13,57,44,FALSE
1844,100,28,155,8,97,89,FALSE
1845,34,3,214,6,22,16,FALSE
1846,103,5,40,17,82,65,FALSE
1847,98,20,20,11,25,14,FALSE
1848,64,16,109,16,53,37,FALSE
1849,108,24,191,17,36,19,FALSE
1850,186,9,30,17,52,35,FALSE
1851,180,7,98,14,98,84,FALSE
1852,38,28,294,14,80,66,FALSE
1853,144,3,275,4,76,72,FALSE
1854,124,10,268,4,54,50,FALSE
1855,113,30,112,9,75,66,FALSE
1856,130,6,167,20,85,65,FALSE
1857,41,2,297,15,28,13,FALSE
1858,122,9,236,13,45,32,FALSE
1859,163,22,41,14,73,59,FALSE
1860,196,21,189,17,91,74,FALSE
1861,63,30,260,7,83,76,FALSE
1862,114,21,55,18,43,25,FALSE
1863,47,13,211,15,31,16,FALSE
1864,80,10,255,13,85,72,FALSE
1865,49,5,72,5,73,68,FALSE
1866,91,17,188,16,28,12,FALSE
1867,161,15,192,4,89,85,FALSE
1868,26,1,89,13,52,39,FALSE
1869,116,1,29,20,34,14,FALSE
1870,190,19,54,11,94,83,FALSE
1871,166,30,164,12,38,26,FALSE
1872,170,6,185,3,64,61,FALSE
1873,151,8,93,13,100,87,FALSE
1874,41,26,249,1,41,40,FALSE
1875,114,20,176,9,82,73,FALSE
1876,44,1,135,8,32,24,FALSE
1877,109,7,246,18,62,44,FALSE
1878,128,17,137,4,28,24,FALSE
1879,199,4,66,17,99,82,FALSE
1880,87,6,217,4,33,29,FALSE
1881,56,11,153,18,66,48,FALSE
1882,137,30,182,13,92,79,True
1883,52,20,95,3,61,58,FALSE
1884,43,11,269,15,36,21,FALSE
1885,80,3,83,10,24,14,FALSE
1886,103,22,97,16,30,14,FALSE
1887,195,5,250,16,95,79,FALSE
1888,153,15,223,15,60,45,FALSE
1889,70,15,278,18,90,72,FALSE
1890,187,27,37,7,29,22,FALSE
1891,72,18,270,4,50,46,FALSE
1892,103,17,109,8,88,80,FALSE
1893,34,30,291,12,77,65,FALSE
1894,96,16,176,20,67,47,FALSE
1895,81,20,128,16,48,32,FALSE
1896,182,20,89,3,37,34,FALSE
1897,141,5,214,16,49,33,FALSE
1898,183,26,266,2,99,97,FALSE
1899,190,6,177,13,30,17,FALSE
1900,175,28,27,1,58,57,True
1901,199,23,36,18,54,36,FALSE
1902,32,20,74,18,27,9,FALSE
1903,45,25,129,19,55,36,FALSE
1904,43,27,266,20,62,42,FALSE
1905,124,9,282,1,57,56,FALSE
1906,158,3,223,15,73,58,FALSE
1907,125,17,106,5,57,52,FALSE
1908,188,9,266,15,84,69,FALSE
1909,91,26,131,7,97,90,FALSE
1910,55,4,236,10,99,89,FALSE
1911,110,30,54,9,51,42,FALSE
1912,189,28,278,12,51,39,FALSE
1913,48,17,112,15,50,35,FALSE
1914,144,21,113,7,82,75,FALSE
1915,25,14,177,9,60,51,FALSE
1916,176,28,21,6,32,26,FALSE
1917,186,3,72,5,81,76,FALSE
1918,190,20,282,11,58,47,FALSE
1919,198,26,179,14,93,79,FALSE
1920,123,25,149,16,72,56,FALSE
1921,114,8,274,13,94,81,FALSE
1922,148,25,42,14,21,7,FALSE
1923,118,20,145,2,26,24,FALSE
1924,110,18,201,15,93,78,FALSE
1925,58,5,261,4,67,63,FALSE
1926,169,27,192,14,54,40,FALSE
1927,40,15,269,5,48,43,FALSE
1928,38,1,174,15,74,59,FALSE
1929,28,23,75,18,78,60,FALSE
1930,101,10,271,15,69,54,FALSE
1931,197,26,78,8,53,45,FALSE
1932,109,29,150,15,24,9,FALSE
1933,124,23,42,8,21,13,FALSE
1934,192,7,112,12,50,38,FALSE
1935,164,28,146,9,89,80,FALSE
1936,81,2,189,12,58,46,FALSE
1937,198,21,56,12,64,52,FALSE
1938,166,11,108,4,30,26,FALSE
1939,101,14,142,11,23,12,FALSE
1940,77,14,43,17,86,69,FALSE
1941,44,22,268,14,98,84,FALSE
1942,60,21,24,16,52,36,FALSE
1943,126,24,222,11,98,87,FALSE
1944,20,20,96,13,43,30,FALSE
1945,143,19,69,5,59,54,True
1946,178,1,239,12,76,64,FALSE
1947,199,15,293,3,49,46,FALSE
1948,78,28,216,19,66,47,FALSE
1949,102,29,43,12,94,82,FALSE
1950,88,9,61,8,38,30,FALSE
1951,194,8,163,16,76,60,FALSE
1952,194,17,119,20,98,78,FALSE
1953,177,20,199,8,40,32,FALSE
1954,134,3,186,1,83,82,FALSE
1955,38,28,214,12,34,22,FALSE
1956,49,19,298,6,55,49,FALSE
1957,156,28,142,6,49,43,FALSE
1958,32,14,62,7,57,50,FALSE
1959,48,6,109,18,98,80,FALSE
1960,111,20,183,17,21,4,FALSE
1961,177,19,60,7,100,93,FALSE
1962,74,18,38,5,88,83,FALSE
1963,64,13,147,12,97,85,FALSE
1964,48,25,232,7,66,59,FALSE
1965,35,6,98,15,88,73,FALSE
1966,93,12,106,20,97,77,FALSE
1967,49,17,265,3,90,87,FALSE
1968,169,28,87,7,84,77,FALSE
1969,144,7,201,5,34,29,FALSE
1970,60,5,249,16,78,62,FALSE
1971,133,21,296,19,76,57,FALSE
1972,127,19,276,14,80,66,FALSE
1973,42,25,185,11,58,47,FALSE
1974,135,5,207,19,67,48,FALSE
1975,187,22,30,1,45,44,FALSE
1976,78,1,35,16,47,31,FALSE
1977,65,3,181,8,63,55,FALSE
1978,169,1,89,3,60,57,FALSE
1979,175,5,158,6,82,76,FALSE
1980,186,29,252,7,89,82,FALSE
1981,113,11,199,16,85,69,FALSE
1982,180,26,218,5,26,21,FALSE
1983,185,17,210,16,86,70,FALSE
1984,80,1,229,15,93,78,FALSE
1985,85,17,275,9,31,22,FALSE
1986,189,2,190,11,35,24,FALSE
1987,68,28,79,12,22,10,FALSE
1988,74,27,55,14,58,44,True
1989,178,23,239,15,59,44,FALSE
1990,43,4,218,7,68,61,FALSE
1991,110,23,88,4,70,66,True
1992,93,19,73,9,22,13,FALSE
1993,30,25,103,10,25,15,FALSE
1994,114,18,91,16,61,45,FALSE
1995,29,2,93,9,95,86,FALSE
1996,35,13,135,19,69,50,FALSE
1997,163,18,293,16,25,9,FALSE
1998,174,1,48,14,35,21,FALSE
1999,184,17,34,18,53,35,FALSE
2000,58,1,64,12,90,78,FALSE
2001,115,16,169,3,42,39,FALSE
2002,142,18,293,11,65,54,FALSE
2003,112,13,143,15,80,65,FALSE
2004,44,29,187,12,28,16,True
2005,137,4,48,10,93,83,FALSE
2006,25,21,99,15,47,32,FALSE
2007,137,4,179,15,36,21,FALSE
2008,151,15,278,10,90,80,FALSE
2009,144,8,289,18,59,41,FALSE
2010,76,13,142,2,35,33,FALSE
2011,193,4,263,2,93,91,FALSE
2012,199,19,222,20,66,46,FALSE
2013,183,13,77,15,92,77,FALSE
2014,84,22,186,7,45,38,FALSE
2015,136,20,82,14,44,30,FALSE
2016,80,22,116,8,50,42,FALSE
2017,31,3,213,18,56,38,FALSE
2018,24,21,81,18,54,36,FALSE
2019,58,16,203,19,22,3,FALSE
2020,92,11,156,12,76,64,FALSE
2021,60,13,61,4,80,76,FALSE
2022,194,2,160,17,92,75,FALSE
2023,116,29,152,5,46,41,FALSE
2024,170,22,82,17,64,47,FALSE
2025,146,23,199,13,79,66,FALSE
2026,197,8,290,16,29,13,FALSE
2027,134,7,272,2,44,42,FALSE
2028,141,9,269,19,36,17,FALSE
2029,149,18,135,8,85,77,FALSE
2030,196,15,72,5,80,75,FALSE
2031,171,27,78,18,76,58,FALSE
2032,141,16,270,7,59,52,FALSE
2033,42,8,239,3,89,86,FALSE
2034,163,28,166,6,82,76,FALSE
2035,42,3,237,16,36,20,FALSE
2036,169,27,206,14,22,8,FALSE
2037,184,19,277,17,73,56,FALSE
2038,127,15,40,8,65,57,FALSE
2039,193,29,218,20,31,11,FALSE
2040,159,29,145,15,87,72,FALSE
2041,132,22,63,13,64,51,FALSE
2042,171,4,87,3,38,35,FALSE
2043,146,29,159,9,83,74,FALSE
2044,128,13,140,1,52,51,FALSE
2045,101,9,74,17,29,12,FALSE
2046,147,1,283,4,74,70,FALSE
2047,54,4,207,1,24,23,FALSE
2048,165,13,61,11,21,10,FALSE
2049,85,20,159,16,52,36,FALSE
2050,90,22,225,14,68,54,FALSE
2051,78,4,131,4,86,82,FALSE
2052,148,16,228,20,74,54,True
2053,133,20,88,20,46,26,FALSE
2054,28,28,220,16,87,71,FALSE
2055,62,14,59,17,83,66,FALSE
2056,168,16,221,19,93,74,FALSE
2057,45,15,171,7,29,22,FALSE
2058,114,24,224,3,74,71,FALSE
2059,65,10,136,4,90,86,FALSE
2060,185,26,150,6,55,49,FALSE
2061,32,26,257,19,96,77,FALSE
2062,117,22,62,18,39,21,FALSE
2063,184,1,106,4,37,33,FALSE
2064,113,15,210,2,74,72,FALSE
2065,154,22,112,12,43,31,FALSE
2066,146,27,273,19,72,53,FALSE
2067,39,1,234,18,80,62,FALSE
2068,171,13,55,16,34,18,FALSE
2069,77,11,107,8,84,76,FALSE
2070,75,19,249,7,31,24,FALSE
2071,22,23,140,10,31,21,FALSE
2072,127,9,21,17,91,74,FALSE
2073,54,10,69,4,40,36,FALSE
2074,105,6,234,10,98,88,FALSE
2075,80,6,170,3,22,19,FALSE
2076,126,23,84,15,44,29,FALSE
2077,54,11,242,9,51,42,FALSE
2078,85,4,81,7,63,56,FALSE
2079,117,13,146,16,55,39,FALSE
2080,198,24,184,10,54,44,FALSE
2081,102,26,297,10,54,44,FALSE
2082,155,14,297,11,65,54,FALSE
2083,163,27,159,4,88,84,FALSE
2084,121,5,189,15,52,37,FALSE
2085,199,22,216,3,31,28,FALSE
2086,55,14,20,8,79,71,FALSE
2087,150,13,37,3,86,83,FALSE
2088,186,23,124,12,69,57,FALSE
2089,78,5,63,1,59,58,FALSE
2090,106,29,245,3,87,84,FALSE
2091,140,7,134,7,67,60,FALSE
2092,31,13,116,11,41,30,FALSE
2093,23,3,264,6,47,41,FALSE
2094,123,18,154,17,95,78,FALSE
2095,128,1,74,8,93,85,FALSE
2096,26,20,87,5,63,58,FALSE
2097,104,18,94,4,93,89,FALSE
2098,166,17,97,3,29,26,FALSE
2099,187,20,170,20,79,59,FALSE
2100,125,16,275,11,88,77,FALSE
2101,32,2,154,13,21,8,FALSE
2102,80,5,294,20,25,5,FALSE
2103,29,25,96,10,82,72,FALSE
2104,36,12,249,13,68,55,FALSE
2105,23,6,90,15,85,70,FALSE
2106,194,18,199,4,55,51,FALSE
2107,22,22,91,1,87,86,FALSE
2108,172,13,120,8,99,91,FALSE
2109,145,6,267,4,50,46,FALSE
2110,24,24,219,20,47,27,FALSE
2111,116,11,211,18,30,12,FALSE
2112,195,4,277,6,86,80,FALSE
2113,46,3,245,3,53,50,FALSE
2114,99,14,21,4,97,93,True
2115,104,13,259,5,23,18,FALSE
2116,199,20,265,8,25,17,FALSE
2117,106,24,261,15,59,44,FALSE
2118,132,5,86,15,63,48,FALSE
2119,194,12,103,5,25,20,FALSE
2120,192,27,100,4,40,36,FALSE
2121,82,18,52,1,35,34,FALSE
2122,81,25,40,8,41,33,FALSE
2123,154,4,295,4,29,25,True
2124,118,27,33,13,69,56,FALSE
2125,144,13,289,15,39,24,FALSE
2126,146,15,205,12,87,75,FALSE
2127,99,10,300,14,78,64,FALSE
2128,116,3,243,8,69,61,FALSE
2129,122,26,106,6,78,72,FALSE
2130,169,30,222,15,50,35,FALSE
2131,82,16,122,3,76,73,FALSE
2132,191,2,169,15,47,32,FALSE
2133,187,16,272,1,89,88,True
2134,156,16,47,2,76,74,FALSE
2135,161,15,168,19,54,35,FALSE
2136,70,15,111,10,30,20,FALSE
2137,95,28,53,15,82,67,FALSE
2138,30,22,174,17,48,31,FALSE
2139,30,7,204,12,25,13,FALSE
2140,179,3,25,15,70,55,FALSE
2141,142,16,85,12,62,50,FALSE
2142,137,6,73,4,37,33,FALSE
2143,38,21,66,18,38,20,FALSE
2144,89,12,271,14,94,80,FALSE
2145,174,6,208,16,24,8,FALSE
2146,39,23,245,18,66,48,FALSE
2147,194,21,195,9,91,82,FALSE
2148,131,12,237,1,25,24,True
2149,193,1,231,3,82,79,FALSE
2150,64,10,174,8,78,70,FALSE
2151,166,30,297,4,86,82,FALSE
2152,26,25,269,17,74,57,FALSE
2153,77,14,133,15,94,79,FALSE
2154,155,23,83,20,41,21,FALSE
2155,91,27,20,5,75,70,FALSE
2156,45,6,29,12,70,58,FALSE
2157,87,4,103,6,89,83,FALSE
2158,157,1,157,14,93,79,FALSE
2159,172,8,235,3,40,37,FALSE
2160,146,22,120,6,44,38,FALSE
2161,52,10,168,11,66,55,FALSE
2162,27,30,226,7,93,86,FALSE
2163,46,29,222,3,92,89,FALSE
2164,162,23,31,2,74,72,FALSE
2165,67,26,294,18,33,15,FALSE
2166,105,5,146,4,55,51,FALSE
2167,21,28,219,5,90,85,FALSE
2168,188,10,234,1,90,89,FALSE
2169,167,14,177,16,88,72,FALSE
2170,36,25,29,10,46,36,FALSE
2171,112,30,117,10,82,72,FALSE
2172,129,9,198,3,83,80,FALSE
2173,179,10,292,3,44,41,FALSE
2174,147,14,266,17,89,72,FALSE
2175,140,6,207,17,67,50,FALSE
2176,83,14,207,11,99,88,FALSE
2177,178,7,230,4,70,66,FALSE
2178,124,4,171,4,86,82,FALSE
2179,199,29,280,4,71,67,True
2180,149,12,157,12,37,25,FALSE
2181,139,5,126,3,73,70,FALSE
2182,64,7,178,15,63,48,FALSE
2183,62,15,145,4,41,37,FALSE
2184,171,6,70,3,51,48,FALSE
2185,101,11,171,20,35,15,FALSE
2186,149,10,67,2,72,70,FALSE
2187,154,11,185,12,27,15,FALSE
2188,92,22,173,14,46,32,FALSE
2189,25,12,260,10,45,35,FALSE
2190,149,7,207,8,73,65,FALSE
2191,52,19,122,5,80,75,FALSE
2192,47,8,87,13,67,54,FALSE
2193,48,28,112,6,47,41,FALSE
2194,172,30,290,5,66,61,FALSE
2195,43,18,185,18,36,18,FALSE
2196,137,21,80,19,52,33,FALSE
2197,91,15,279,20,80,60,FALSE
2198,92,12,273,6,59,53,FALSE
2199,111,25,92,2,22,20,FALSE
2200,108,4,23,17,69,52,FALSE
2201,112,22,71,13,23,10,FALSE
2202,173,26,171,13,51,38,FALSE
2203,186,2,199,17,90,73,FALSE
2204,86,15,111,11,71,60,FALSE
2205,53,15,85,10,82,72,FALSE
2206,137,9,200,9,79,70,FALSE
2207,176,25,144,7,54,47,FALSE
2208,145,20,279,7,37,30,FALSE
2209,189,21,86,7,84,77,FALSE
2210,21,23,256,15,71,56,FALSE
2211,195,8,229,20,89,69,FALSE
2212,127,6,296,9,47,38,FALSE
2213,40,13,74,12,52,40,FALSE
2214,180,25,280,2,57,55,FALSE
2215,172,5,153,2,87,85,FALSE
2216,36,17,72,18,40,22,FALSE
2217,84,9,294,12,26,14,FALSE
2218,30,2,216,12,88,76,FALSE
2219,111,30,258,3,27,24,FALSE
2220,75,2,238,12,53,41,FALSE
2221,28,15,215,19,82,63,FALSE
2222,154,23,187,2,89,87,FALSE
2223,35,12,198,15,50,35,FALSE
2224,68,10,262,5,24,19,FALSE
2225,67,18,205,16,66,50,FALSE
2226,115,11,69,20,27,7,True
2227,75,16,20,17,42,25,FALSE
2228,155,17,293,12,82,70,FALSE
2229,40,21,267,17,55,38,FALSE
2230,184,19,38,15,22,7,FALSE
2231,47,23,159,8,23,15,FALSE
2232,52,15,211,11,83,72,FALSE
2233,128,22,148,7,21,14,FALSE
2234,135,12,215,12,79,67,FALSE
2235,84,11,280,3,26,23,FALSE
2236,67,11,208,3,53,50,FALSE
2237,194,17,60,16,45,29,FALSE
2238,149,30,147,16,59,43,FALSE
2239,104,3,22,3,35,32,FALSE
2240,87,16,105,6,49,43,FALSE
2241,185,29,77,2,93,91,FALSE
2242,78,29,139,12,58,46,FALSE
2243,179,3,52,13,31,18,True
2244,53,7,35,1,99,98,FALSE
2245,77,15,262,2,51,49,FALSE
2246,120,7,39,9,95,86,FALSE
2247,135,4,292,2,92,90,FALSE
2248,85,30,214,15,53,38,FALSE
2249,139,13,239,12,38,26,FALSE
2250,48,23,138,6,44,38,FALSE
2251,145,25,261,19,93,74,FALSE
2252,55,29,75,5,44,39,FALSE
2253,55,5,171,11,88,77,FALSE
2254,129,18,155,11,70,59,FALSE
2255,23,25,236,10,68,58,FALSE
2256,70,28,231,14,25,11,FALSE
2257,115,9,158,9,38,29,FALSE
2258,74,21,160,8,79,71,FALSE
2259,88,15,259,11,94,83,FALSE
2260,56,21,39,10,30,20,FALSE
2261,107,5,103,2,34,32,FALSE
2262,107,17,214,12,59,47,FALSE
2263,76,11,254,18,58,40,FALSE
2264,91,14,146,4,100,96,FALSE
2265,53,1,22,20,76,56,FALSE
2266,135,2,265,6,75,69,FALSE
2267,151,11,101,4,27,23,FALSE
2268,141,18,217,16,25,9,FALSE
2269,146,18,296,10,74,64,FALSE
2270,177,19,42,20,61,41,FALSE
2271,126,29,63,13,67,54,FALSE
2272,56,26,34,1,67,66,FALSE
2273,184,29,219,18,45,27,FALSE
2274,169,13,288,11,72,61,FALSE
2275,81,1,174,7,30,23,FALSE
2276,186,30,202,1,54,53,FALSE
2277,49,26,99,19,24,5,FALSE
2278,36,28,79,6,41,35,FALSE
2279,21,8,225,14,74,60,FALSE
2280,28,1,69,16,52,36,FALSE
2281,169,2,167,3,26,23,FALSE
2282,181,21,277,16,25,9,FALSE
2283,106,22,278,17,26,9,FALSE
2284,189,20,77,5,60,55,FALSE
2285,180,4,185,16,37,21,FALSE
2286,71,22,201,10,74,64,FALSE
2287,38,28,291,19,20,1,FALSE
2288,121,29,255,1,46,45,FALSE
2289,185,9,176,3,82,79,FALSE
2290,119,26,274,8,40,32,FALSE
2291,106,10,285,17,75,58,FALSE
2292,116,1,30,19,64,45,FALSE
2293,182,1,180,2,66,64,FALSE
2294,147,30,101,1,34,33,FALSE
2295,104,2,88,8,98,90,FALSE
2296,84,6,207,10,87,77,FALSE
2297,176,7,62,10,32,22,FALSE
2298,107,29,292,18,20,2,FALSE
2299,70,25,122,6,23,17,FALSE
2300,26,16,64,8,43,35,FALSE
2301,175,16,201,7,36,29,FALSE
2302,35,12,29,15,96,81,True
2303,41,15,79,19,22,3,FALSE
2304,162,29,277,7,60,53,FALSE
2305,105,27,59,2,31,29,FALSE
2306,45,17,58,16,90,74,FALSE
2307,196,2,221,7,82,75,FALSE
2308,168,29,140,9,99,90,FALSE
2309,43,12,251,11,87,76,FALSE
2310,79,1,198,11,96,85,FALSE
2311,198,18,178,19,48,29,FALSE
2312,139,16,34,4,69,65,FALSE
2313,62,24,145,20,47,27,FALSE
2314,176,17,66,8,76,68,FALSE
2315,92,19,29,6,61,55,FALSE
2316,78,8,300,7,33,26,FALSE
2317,139,6,188,8,65,57,FALSE
2318,177,8,46,15,87,72,FALSE
2319,52,25,113,11,35,24,FALSE
2320,64,6,296,12,61,49,FALSE
2321,57,21,102,2,55,53,FALSE
2322,93,18,281,11,23,12,True
2323,43,20,101,13,83,70,FALSE
2324,84,13,120,1,74,73,FALSE
2325,90,2,278,19,66,47,FALSE
2326,88,18,29,18,27,9,FALSE
2327,35,2,286,20,93,73,FALSE
2328,200,15,69,18,95,77,FALSE
2329,90,23,206,8,74,66,FALSE
2330,41,18,149,20,48,28,FALSE
2331,97,27,149,18,37,19,FALSE
2332,189,14,290,10,72,62,FALSE
2333,199,21,110,8,53,45,FALSE
2334,168,14,240,18,84,66,FALSE
2335,97,12,185,17,33,16,FALSE
2336,152,4,105,10,70,60,FALSE
2337,49,19,246,1,33,32,FALSE
2338,80,27,43,20,27,7,FALSE
2339,22,25,121,17,86,69,FALSE
2340,177,8,177,2,58,56,FALSE
2341,54,3,252,17,71,54,FALSE
2342,188,17,72,3,23,20,FALSE
2343,157,19,189,18,66,48,FALSE
2344,77,9,56,6,100,94,FALSE
2345,114,30,268,5,80,75,FALSE
2346,177,1,79,10,51,41,FALSE
2347,154,12,203,10,87,77,FALSE
2348,160,16,208,9,93,84,FALSE
2349,188,3,72,1,74,73,FALSE
2350,134,26,122,20,90,70,FALSE
2351,40,23,24,10,26,16,FALSE
2352,24,14,228,8,47,39,FALSE
2353,50,4,46,15,86,71,FALSE
2354,109,3,206,7,68,61,FALSE
2355,106,2,206,16,37,21,FALSE
2356,93,8,273,14,96,82,FALSE
2357,51,1,162,7,51,44,FALSE
2358,22,4,270,18,22,4,FALSE
2359,158,8,128,18,66,48,FALSE
2360,32,28,138,12,38,26,FALSE
2361,141,4,256,11,34,23,FALSE
2362,175,21,213,3,99,96,FALSE
2363,156,9,276,1,96,95,FALSE
2364,86,27,297,6,26,20,FALSE
2365,40,13,144,13,80,67,FALSE
2366,160,22,73,1,44,43,FALSE
2367,73,5,169,4,79,75,FALSE
2368,34,15,213,7,95,88,FALSE
2369,72,28,243,18,98,80,FALSE
2370,82,7,281,4,61,57,FALSE
2371,43,8,156,17,69,52,FALSE
2372,128,4,241,12,20,8,FALSE
2373,20,4,127,2,47,45,FALSE
2374,94,16,33,7,96,89,FALSE
2375,98,12,272,5,23,18,FALSE
2376,115,12,109,5,90,85,True
2377,48,18,276,3,24,21,FALSE
2378,130,10,41,15,42,27,True
2379,58,19,204,18,92,74,FALSE
2380,64,26,195,8,91,83,FALSE
2381,193,2,130,8,90,82,FALSE
2382,101,2,180,13,57,44,FALSE
2383,91,1,192,19,42,23,FALSE
2384,61,29,135,9,80,71,FALSE
2385,185,29,236,4,71,67,FALSE
2386,193,4,297,2,34,32,FALSE
2387,154,2,134,10,29,19,FALSE
2388,153,5,194,20,93,73,FALSE
2389,102,13,255,5,81,76,True
2390,107,22,22,14,98,84,FALSE
2391,129,27,139,18,45,27,FALSE
2392,122,26,240,11,63,52,FALSE
2393,191,5,237,4,87,83,FALSE
2394,160,20,134,5,90,85,FALSE
2395,75,30,219,17,87,70,FALSE
2396,68,7,34,18,66,48,FALSE
2397,74,7,265,15,64,49,FALSE
2398,182,6,81,16,74,58,FALSE
2399,36,30,58,18,77,59,FALSE
2400,25,30,92,3,76,73,FALSE
2401,189,8,39,8,54,46,FALSE
2402,130,13,206,13,97,84,FALSE
2403,118,12,239,15,21,6,FALSE
2404,194,3,231,2,100,98,FALSE
2405,78,10,107,16,71,55,FALSE
2406,108,20,229,14,44,30,True
2407,22,3,88,8,54,46,FALSE
2408,52,4,191,3,38,35,FALSE
2409,71,28,93,9,42,33,FALSE
2410,137,6,286,5,31,26,FALSE
2411,172,23,190,11,72,61,FALSE
2412,89,18,61,13,32,19,FALSE
2413,38,12,166,12,70,58,FALSE
2414,91,10,234,2,60,58,FALSE
2415,187,11,244,1,94,93,FALSE
2416,48,27,102,13,52,39,FALSE
2417,123,12,96,7,87,80,FALSE
2418,158,4,31,3,83,80,FALSE
2419,196,23,152,6,56,50,FALSE
2420,61,30,152,3,91,88,FALSE
2421,105,13,125,9,51,42,FALSE
2422,195,17,120,7,64,57,FALSE
2423,171,27,247,16,34,18,True
2424,84,1,66,9,46,37,FALSE
2425,69,18,266,5,89,84,FALSE
2426,66,4,182,9,86,77,FALSE
2427,46,28,119,5,33,28,FALSE
2428,83,17,62,13,28,15,FALSE
2429,122,27,122,14,52,38,FALSE
2430,129,9,267,19,91,72,FALSE
2431,67,20,201,7,67,60,FALSE
2432,178,20,248,1,72,71,FALSE
2433,66,16,248,19,48,29,FALSE
2434,199,2,92,20,49,29,FALSE
2435,85,18,103,11,81,70,FALSE
2436,98,25,166,15,52,37,FALSE
2437,146,16,142,4,30,26,FALSE
2438,130,24,135,5,40,35,FALSE
2439,142,23,95,15,65,50,FALSE
2440,167,3,100,1,23,22,FALSE
2441,162,4,157,11,31,20,FALSE
2442,138,1,182,3,40,37,FALSE
2443,47,21,81,5,33,28,FALSE
2444,191,12,112,7,34,27,FALSE
2445,76,9,72,17,58,41,FALSE
2446,131,1,152,15,71,56,FALSE
2447,34,18,88,13,63,50,FALSE
2448,134,15,87,14,54,40,FALSE
2449,53,3,208,20,85,65,FALSE
2450,58,26,290,20,42,22,FALSE
2451,21,16,227,6,85,79,FALSE
2452,71,11,190,16,90,74,FALSE
2453,164,1,138,7,70,63,FALSE
2454,46,23,190,20,23,3,FALSE
2455,147,2,266,10,72,62,FALSE
2456,27,7,254,1,83,82,FALSE
2457,60,28,214,19,76,57,FALSE
2458,172,18,135,8,24,16,FALSE
2459,41,1,291,16,74,58,FALSE
2460,39,24,294,19,88,69,FALSE
2461,195,2,83,6,68,62,FALSE
2462,76,18,143,18,94,76,FALSE
2463,197,19,282,20,21,1,FALSE
2464,55,5,283,16,42,26,FALSE
2465,193,10,29,2,52,50,FALSE
2466,186,22,24,14,73,59,FALSE
2467,56,22,123,2,90,88,FALSE
2468,84,28,142,2,41,39,FALSE
2469,88,15,40,8,75,67,FALSE
2470,160,11,102,13,95,82,FALSE
2471,68,12,232,18,87,69,FALSE
2472,48,17,126,7,20,13,FALSE
2473,137,10,123,8,92,84,FALSE
2474,170,7,288,3,57,54,FALSE
2475,123,10,52,10,22,12,True
2476,110,2,59,17,78,61,FALSE
2477,173,30,198,18,35,17,True
2478,104,21,174,6,22,16,FALSE
2479,31,10,226,1,50,49,FALSE
2480,177,2,134,5,47,42,FALSE
2481,170,29,124,10,22,12,FALSE
2482,149,23,264,17,91,74,FALSE
2483,144,29,172,12,68,56,FALSE
2484,173,2,244,14,72,58,FALSE
2485,184,16,90,3,56,53,FALSE
2486,130,15,99,20,46,26,FALSE
2487,129,29,164,18,74,56,FALSE
2488,45,9,167,12,24,12,FALSE
2489,167,15,274,8,48,40,FALSE
2490,81,17,206,11,95,84,FALSE
2491,180,16,205,7,50,43,FALSE
2492,42,4,200,1,74,73,FALSE
2493,198,29,99,13,97,84,FALSE
2494,46,24,261,10,31,21,FALSE
2495,37,20,107,9,74,65,FALSE
2496,80,14,126,8,60,52,FALSE
2497,38,9,136,19,43,24,FALSE
2498,164,3,68,15,82,67,FALSE
2499,22,29,243,13,59,46,FALSE
2500,123,7,58,15,57,42,FALSE
2501,111,29,245,13,98,85,FALSE
2502,129,4,170,16,28,12,FALSE
2503,32,1,88,11,89,78,FALSE
2504,173,28,132,11,53,42,True
2505,112,20,182,6,37,31,FALSE
2506,139,30,85,15,69,54,True
2507,35,12,247,20,84,64,FALSE
2508,73,14,257,18,92,74,FALSE
2509,73,7,109,13,29,16,FALSE
2510,176,21,89,17,52,35,FALSE
2511,101,3,188,17,82,65,FALSE
2512,112,10,106,7,50,43,FALSE
2513,29,3,188,6,86,80,FALSE
2514,168,14,44,11,86,75,FALSE
2515,82,7,162,20,55,35,FALSE
2516,132,23,60,17,34,17,FALSE
2517,194,5,157,8,75,67,FALSE
2518,121,12,59,18,47,29,FALSE
2519,100,15,122,6,99,93,FALSE
2520,97,7,234,16,90,74,FALSE
2521,160,27,202,18,21,3,FALSE
2522,46,27,70,14,95,81,FALSE
2523,63,19,65,20,90,70,FALSE
2524,134,14,217,7,80,73,FALSE
2525,40,12,38,11,82,71,FALSE
2526,197,26,161,4,95,91,FALSE
2527,84,13,165,6,43,37,FALSE
2528,31,2,225,5,55,50,FALSE
2529,39,27,131,5,37,32,FALSE
2530,137,27,236,11,96,85,FALSE
2531,53,14,96,14,87,73,FALSE
2532,67,5,271,13,79,66,FALSE
2533,115,27,148,16,45,29,FALSE
2534,132,8,65,16,36,20,FALSE
2535,161,16,257,12,49,37,FALSE
2536,106,21,102,1,46,45,FALSE
2537,113,2,186,2,60,58,FALSE
2538,175,4,272,5,30,25,FALSE
2539,47,25,284,1,93,92,FALSE
2540,106,25,185,16,57,41,FALSE
2541,162,21,217,20,89,69,FALSE
2542,187,30,167,17,42,25,FALSE
2543,198,20,109,12,99,87,FALSE
2544,192,6,40,9,89,80,FALSE
2545,105,6,51,2,51,49,FALSE
2546,113,15,197,10,40,30,FALSE
2547,113,10,178,15,76,61,FALSE
2548,116,8,295,20,43,23,FALSE
2549,179,2,230,7,57,50,FALSE
2550,157,5,244,1,64,63,FALSE
2551,73,11,99,1,70,69,FALSE
2552,130,22,151,12,42,30,FALSE
2553,191,14,28,20,95,75,FALSE
2554,173,5,211,16,94,78,FALSE
2555,129,2,204,7,75,68,FALSE
2556,71,14,126,16,67,51,FALSE
2557,154,29,90,14,34,20,FALSE
2558,135,15,42,1,70,69,FALSE
2559,164,14,23,20,26,6,FALSE
2560,123,30,104,11,67,56,FALSE
2561,25,3,174,5,59,54,FALSE
2562,27,13,227,2,47,45,FALSE
2563,182,19,36,20,55,35,FALSE
2564,28,13,66,1,92,91,FALSE
2565,181,4,128,20,84,64,FALSE
2566,172,12,123,18,62,44,FALSE
2567,165,30,115,20,50,30,FALSE
2568,169,13,204,10,22,12,FALSE
2569,92,15,256,14,49,35,FALSE
2570,127,8,69,10,97,87,FALSE
2571,178,2,239,14,77,63,FALSE
2572,105,7,104,9,55,46,FALSE
2573,111,1,118,14,32,18,FALSE
2574,169,7,202,15,65,50,FALSE
2575,146,20,146,17,24,7,FALSE
2576,193,19,298,20,23,3,FALSE
2577,147,27,70,17,33,16,True
2578,150,6,286,1,62,61,FALSE
2579,188,3,97,1,59,58,FALSE
2580,108,20,41,17,56,39,FALSE
2581,129,14,158,20,92,72,FALSE
2582,142,11,200,3,94,91,FALSE
2583,65,5,34,5,76,71,FALSE
2584,56,26,240,17,75,58,FALSE
2585,24,4,278,5,60,55,FALSE
2586,30,17,250,8,70,62,FALSE
2587,173,10,278,1,24,23,FALSE
2588,57,16,38,12,34,22,FALSE
2589,68,19,119,17,66,49,FALSE
2590,98,26,261,10,70,60,FALSE
2591,110,12,156,17,42,25,FALSE
2592,133,18,102,20,32,12,FALSE
2593,33,23,63,6,61,55,FALSE
2594,58,27,95,9,82,73,FALSE
2595,150,12,274,17,77,60,FALSE
2596,83,27,130,4,54,50,FALSE
2597,192,5,290,1,66,65,FALSE
2598,123,12,22,18,72,54,FALSE
2599,150,6,159,10,70,60,FALSE
2600,95,6,79,19,75,56,FALSE
2601,166,13,59,12,48,36,FALSE
2602,190,6,220,8,65,57,FALSE
2603,90,21,286,14,82,68,FALSE
2604,142,10,239,7,95,88,FALSE
2605,92,28,80,1,22,21,FALSE
2606,190,30,299,6,42,36,FALSE
2607,52,9,233,9,30,21,FALSE
2608,98,21,99,19,100,81,FALSE
2609,109,23,247,13,45,32,FALSE
2610,36,28,267,20,59,39,FALSE
2611,148,28,129,5,76,71,FALSE
2612,82,28,39,18,23,5,FALSE
2613,146,2,72,6,23,17,FALSE
2614,192,22,287,11,91,80,FALSE
2615,123,10,112,19,58,39,FALSE
2616,136,3,72,7,37,30,FALSE
2617,111,19,295,16,70,54,FALSE
2618,111,30,150,13,54,41,FALSE
2619,74,27,206,13,84,71,FALSE
2620,73,8,44,3,60,57,FALSE
2621,102,12,208,4,57,53,FALSE
2622,180,14,48,20,87,67,FALSE
2623,103,10,195,15,22,7,FALSE
2624,30,4,76,8,73,65,FALSE
2625,89,26,35,4,96,92,FALSE
2626,107,15,137,8,89,81,FALSE
2627,104,22,87,18,74,56,FALSE
2628,24,26,41,1,33,32,FALSE
2629,48,4,112,1,54,53,FALSE
2630,104,28,127,15,39,24,FALSE
2631,31,13,207,6,36,30,FALSE
2632,61,2,163,15,36,21,FALSE
2633,180,19,112,16,93,77,FALSE
2634,131,18,158,20,55,35,FALSE
2635,118,14,135,19,58,39,FALSE
2636,86,8,51,11,33,22,FALSE
2637,55,14,84,2,38,36,FALSE
2638,54,15,59,18,71,53,FALSE
2639,49,17,194,3,91,88,FALSE
2640,118,3,53,20,92,72,FALSE
2641,40,5,79,17,66,49,FALSE
2642,28,20,275,8,43,35,FALSE
2643,177,5,192,12,56,44,FALSE
2644,44,24,62,20,72,52,FALSE
2645,40,25,204,9,31,22,FALSE
2646,36,13,101,19,82,63,FALSE
2647,32,18,262,9,68,59,True
2648,151,10,243,3,32,29,FALSE
2649,181,22,290,15,52,37,FALSE
2650,88,5,92,20,43,23,FALSE
2651,29,23,70,4,63,59,FALSE
2652,154,30,208,6,30,24,FALSE
2653,29,11,151,3,56,53,FALSE
2654,152,9,236,1,44,43,FALSE
2655,175,20,60,9,56,47,FALSE
2656,98,23,148,18,85,67,FALSE
2657,24,8,234,7,28,21,FALSE
2658,186,11,290,5,40,35,FALSE
2659,69,22,185,10,95,85,FALSE
2660,50,12,41,3,49,46,FALSE
2661,107,6,135,12,73,61,FALSE
2662,169,17,84,6,96,90,FALSE
2663,77,9,191,1,59,58,FALSE
2664,156,2,274,6,60,54,FALSE
2665,40,30,77,2,74,72,FALSE
2666,189,30,300,14,72,58,FALSE
2667,165,11,224,20,84,64,FALSE
2668,178,2,89,5,91,86,FALSE
2669,134,24,51,16,84,68,True
2670,145,8,69,5,40,35,FALSE
2671,83,13,204,20,37,17,True
2672,20,20,279,12,58,46,FALSE
2673,23,20,170,15,43,28,FALSE
2674,24,20,197,14,40,26,FALSE
2675,23,18,217,3,74,71,FALSE
2676,123,19,297,16,79,63,FALSE
2677,65,24,226,9,26,17,FALSE
2678,83,22,59,7,49,42,FALSE
2679,149,22,285,20,76,56,FALSE
2680,55,18,21,1,89,88,FALSE
2681,49,24,88,17,91,74,FALSE
2682,186,9,127,4,26,22,FALSE
2683,108,10,66,1,32,31,True
2684,177,24,82,12,44,32,FALSE
2685,139,28,142,3,61,58,FALSE
2686,51,15,157,9,32,23,FALSE
2687,98,28,36,16,21,5,FALSE
2688,24,3,115,6,66,60,FALSE
2689,74,16,245,12,74,62,FALSE
2690,63,2,162,6,39,33,FALSE
2691,194,15,88,6,98,92,FALSE
2692,67,3,69,2,95,93,FALSE
2693,37,5,65,20,31,11,FALSE
2694,55,29,299,9,70,61,FALSE
2695,51,10,183,18,40,22,FALSE
2696,61,1,238,6,87,81,FALSE
2697,90,26,205,9,95,86,FALSE
2698,23,23,200,17,75,58,FALSE
2699,95,3,170,1,54,53,FALSE
2700,200,30,274,18,86,68,FALSE
2701,190,29,144,15,100,85,FALSE
2702,128,9,103,4,80,76,FALSE
2703,103,17,200,1,44,43,FALSE
2704,143,13,264,15,85,70,FALSE
2705,150,13,251,4,76,72,FALSE
2706,26,11,158,16,26,10,FALSE
2707,83,3,227,2,21,19,FALSE
2708,154,28,280,17,63,46,FALSE
2709,71,12,57,5,22,17,FALSE
2710,197,24,242,10,80,70,FALSE
2711,118,8,56,8,28,20,FALSE
2712,139,17,100,9,75,66,FALSE
2713,104,22,187,16,39,23,FALSE
2714,65,27,199,7,20,13,FALSE
2715,32,7,265,18,56,38,FALSE
2716,42,10,245,5,23,18,FALSE
2717,169,8,123,2,61,59,FALSE
2718,85,24,222,18,73,55,FALSE
2719,59,1,72,13,31,18,FALSE
2720,20,9,55,16,64,48,FALSE
2721,62,5,105,15,68,53,FALSE
2722,190,2,253,19,63,44,FALSE
2723,138,20,79,19,70,51,FALSE
2724,113,29,269,19,97,78,FALSE
2725,71,5,44,14,70,56,FALSE
2726,42,13,119,10,87,77,FALSE
2727,26,4,207,4,33,29,FALSE
2728,48,7,293,3,62,59,FALSE
2729,83,15,52,12,49,37,FALSE
2730,70,21,139,8,74,66,FALSE
2731,168,21,99,2,22,20,FALSE
2732,140,12,211,11,70,59,FALSE
2733,129,29,291,19,59,40,FALSE
2734,65,11,189,19,57,38,FALSE
2735,123,30,199,18,81,63,FALSE
2736,94,18,213,1,35,34,FALSE
2737,193,2,93,11,62,51,FALSE
2738,98,20,237,19,41,22,FALSE
2739,174,17,210,19,97,78,FALSE
2740,42,22,137,12,35,23,FALSE
2741,140,22,182,11,60,49,FALSE
2742,130,30,157,16,49,33,FALSE
2743,157,21,69,6,96,90,FALSE
2744,150,19,104,8,51,43,FALSE
2745,36,2,88,10,34,24,FALSE
2746,108,21,221,4,52,48,FALSE
2747,86,28,148,13,30,17,FALSE
2748,95,15,267,16,68,52,FALSE
2749,100,4,49,11,98,87,FALSE
2750,49,16,86,14,79,65,FALSE
2751,103,21,282,7,20,13,FALSE
2752,178,8,160,11,69,58,FALSE
2753,86,29,262,2,46,44,FALSE
2754,151,17,164,12,48,36,FALSE
2755,125,25,122,6,89,83,FALSE
2756,106,17,164,17,56,39,FALSE
2757,136,21,293,3,51,48,FALSE
2758,66,18,290,12,63,51,FALSE
2759,157,14,119,20,51,31,FALSE
2760,34,22,174,11,89,78,FALSE
2761,198,21,67,1,22,21,FALSE
2762,40,17,261,15,73,58,True
2763,73,17,84,4,90,86,FALSE
2764,181,16,136,8,90,82,FALSE
2765,76,10,67,15,74,59,FALSE
2766,117,16,78,9,62,53,FALSE
2767,139,9,133,18,31,13,FALSE
2768,33,3,210,13,59,46,FALSE
2769,33,21,197,1,78,77,FALSE
2770,189,14,246,6,86,80,FALSE
2771,162,11,69,9,35,26,FALSE
2772,165,15,216,17,27,10,FALSE
2773,196,12,69,9,57,48,FALSE
2774,197,2,246,13,53,40,FALSE
2775,45,26,94,11,51,40,FALSE
2776,83,30,87,17,65,48,FALSE
2777,138,4,57,6,54,48,FALSE
2778,31,29,228,15,76,61,FALSE
2779,85,30,184,13,95,82,FALSE
2780,132,27,112,12,37,25,FALSE
2781,80,26,228,13,28,15,FALSE
2782,44,30,247,17,65,48,FALSE
2783,171,6,109,11,76,65,FALSE
2784,58,10,75,1,76,75,FALSE
2785,157,19,196,7,29,22,FALSE
2786,48,23,238,7,77,70,FALSE
2787,60,18,271,14,81,67,FALSE
2788,179,15,150,5,51,46,FALSE
2789,109,4,276,14,20,6,FALSE
2790,136,16,152,17,23,6,FALSE
2791,146,30,126,4,59,55,FALSE
2792,125,10,223,9,38,29,FALSE
2793,97,25,161,3,70,67,FALSE
2794,178,2,60,7,41,34,True
2795,182,14,209,1,66,65,FALSE
2796,180,30,252,14,55,41,FALSE
2797,61,15,49,9,51,42,FALSE
2798,112,30,169,19,28,9,FALSE
2799,99,28,27,5,72,67,FALSE
2800,183,3,297,9,62,53,FALSE
2801,141,6,29,3,69,66,FALSE
2802,186,9,153,1,32,31,FALSE
2803,97,18,193,7,42,35,FALSE
2804,191,4,224,4,68,64,FALSE
2805,191,10,38,1,90,89,FALSE
2806,171,28,100,20,52,32,FALSE
2807,138,21,147,12,36,24,FALSE
2808,121,9,132,1,64,63,FALSE
2809,128,27,156,4,80,76,FALSE
2810,77,5,42,7,75,68,FALSE
2811,194,1,107,13,30,17,FALSE
2812,94,21,211,19,22,3,FALSE
2813,44,17,32,18,27,9,FALSE
2814,165,20,64,4,57,53,FALSE
2815,176,8,83,16,64,48,FALSE
2816,125,22,275,8,99,91,FALSE
2817,69,24,205,13,89,76,FALSE
2818,118,2,186,12,99,87,FALSE
2819,131,17,289,10,87,77,FALSE
2820,160,1,244,2,97,95,FALSE
2821,119,3,175,2,55,53,FALSE
2822,69,29,241,1,42,41,FALSE
2823,183,22,246,12,69,57,FALSE
2824,119,16,46,6,70,64,FALSE
2825,32,2,36,14,95,81,FALSE
2826,41,1,179,15,67,52,FALSE
2827,128,3,147,1,37,36,FALSE
2828,114,4,128,13,20,7,FALSE
2829,108,26,144,13,82,69,FALSE
2830,69,7,272,1,100,99,FALSE
2831,96,22,252,14,28,14,FALSE
2832,35,30,60,9,91,82,FALSE
2833,110,21,268,5,27,22,FALSE
2834,185,10,281,13,45,32,FALSE
2835,200,27,140,14,59,45,FALSE
2836,119,9,125,4,90,86,FALSE
2837,159,1,97,2,46,44,FALSE
2838,42,14,115,15,20,5,FALSE
2839,80,28,131,10,62,52,FALSE
2840,65,4,33,11,49,38,FALSE
2841,173,18,177,13,93,80,FALSE
2842,84,16,124,8,21,13,FALSE
2843,166,22,72,8,37,29,FALSE
2844,69,24,191,20,41,21,FALSE
2845,89,20,68,9,65,56,FALSE
2846,42,30,64,20,25,5,FALSE
2847,131,9,284,17,75,58,FALSE
2848,153,2,146,14,32,18,FALSE
2849,36,2,167,20,91,71,FALSE
2850,39,21,31,18,78,60,True
2851,200,21,197,15,53,38,FALSE
2852,173,3,34,4,25,21,FALSE
2853,177,10,187,13,55,42,FALSE
2854,186,22,190,5,35,30,FALSE
2855,143,14,119,11,93,82,FALSE
2856,145,3,48,5,38,33,FALSE
2857,180,25,143,7,68,61,FALSE
2858,22,22,74,15,41,26,FALSE
2859,147,20,209,5,73,68,FALSE
2860,199,23,136,15,99,84,FALSE
2861,182,23,244,3,52,49,FALSE
2862,34,6,117,15,44,29,FALSE
2863,61,23,158,6,35,29,FALSE
2864,123,14,256,16,86,70,FALSE
2865,130,10,51,16,37,21,FALSE
2866,98,17,185,11,50,39,FALSE
2867,189,16,196,6,98,92,FALSE
2868,93,29,260,6,20,14,True
2869,138,30,265,12,24,12,FALSE
2870,100,19,123,20,31,11,True
2871,97,10,99,20,94,74,FALSE
2872,88,4,156,4,26,22,FALSE
2873,166,29,220,16,34,18,FALSE
2874,42,10,252,3,96,93,FALSE
2875,74,1,194,7,85,78,FALSE
2876,168,5,216,15,78,63,FALSE
2877,186,18,185,11,51,40,FALSE
2878,65,10,102,17,81,64,FALSE
2879,140,26,277,5,97,92,FALSE
2880,37,30,59,4,30,26,FALSE
2881,107,13,57,17,36,19,FALSE
2882,89,18,278,3,78,75,FALSE
2883,131,30,42,10,61,51,FALSE
2884,29,11,101,5,30,25,FALSE
2885,21,22,176,6,23,17,FALSE
2886,51,17,59,7,59,52,FALSE
2887,74,17,297,10,34,24,FALSE
2888,75,12,232,1,49,48,FALSE
2889,21,15,180,15,30,15,FALSE
2890,39,19,235,2,91,89,FALSE
2891,114,25,218,18,27,9,FALSE
2892,147,3,156,12,58,46,FALSE
2893,194,2,104,1,78,77,FALSE
2894,152,29,222,17,63,46,FALSE
2895,50,15,158,6,95,89,FALSE
2896,50,1,286,6,65,59,FALSE
2897,154,13,201,9,25,16,FALSE
2898,192,12,116,16,32,16,FALSE
2899,81,13,194,5,27,22,FALSE
2900,83,4,134,6,56,50,FALSE
2901,132,13,111,13,29,16,FALSE
2902,148,29,64,1,46,45,FALSE
2903,156,1,34,16,73,57,FALSE
2904,78,6,135,7,46,39,FALSE
2905,121,16,208,6,87,81,FALSE
2906,154,29,237,20,43,23,FALSE
2907,177,27,162,15,90,75,FALSE
2908,78,14,135,18,55,37,FALSE
2909,105,27,100,3,79,76,FALSE
2910,116,4,114,9,40,31,FALSE
2911,67,10,242,13,97,84,FALSE
2912,96,11,153,4,86,82,FALSE
2913,168,1,261,18,93,75,FALSE
2914,177,14,188,2,43,41,FALSE
2915,174,7,291,20,83,63,FALSE
2916,104,24,134,11,21,10,True
2917,104,22,237,9,54,45,FALSE
2918,157,4,65,15,71,56,FALSE
2919,27,27,230,20,84,64,FALSE
2920,69,10,186,16,73,57,FALSE
2921,122,10,191,12,27,15,FALSE
2922,68,9,271,17,69,52,FALSE
2923,66,27,138,17,91,74,FALSE
2924,108,6,27,8,77,69,FALSE
2925,39,15,133,19,73,54,FALSE
2926,54,14,293,11,92,81,FALSE
2927,29,27,219,12,49,37,FALSE
2928,169,13,245,4,79,75,FALSE
2929,197,18,57,12,75,63,FALSE
2930,58,6,37,5,30,25,FALSE
2931,147,23,93,18,27,9,FALSE
2932,151,3,85,16,70,54,FALSE
2933,119,3,63,10,91,81,FALSE
2934,38,2,168,20,40,20,FALSE
2935,82,10,261,3,39,36,FALSE
2936,116,25,159,7,28,21,FALSE
2937,75,5,39,17,29,12,FALSE
2938,42,18,146,10,81,71,FALSE
2939,118,26,39,19,33,14,FALSE
2940,111,26,120,13,75,62,FALSE
2941,116,10,76,1,44,43,FALSE
2942,155,13,111,20,66,46,FALSE
2943,162,25,205,19,57,38,FALSE
2944,159,15,24,12,40,28,FALSE
2945,175,27,266,5,91,86,FALSE
2946,189,5,55,19,90,71,FALSE
2947,119,7,63,3,84,81,FALSE
2948,90,6,219,8,53,45,FALSE
2949,82,23,205,6,22,16,FALSE
2950,38,6,88,14,22,8,FALSE
2951,95,8,252,20,86,66,FALSE
2952,80,15,268,3,60,57,FALSE
2953,161,23,53,3,69,66,FALSE
2954,181,13,148,17,22,5,FALSE
2955,55,9,212,10,68,58,FALSE
2956,197,7,78,5,62,57,FALSE
2957,51,22,286,15,63,48,FALSE
2958,98,21,234,9,80,71,FALSE
2959,64,10,114,1,66,65,FALSE
2960,67,24,226,20,32,12,FALSE
2961,134,11,278,19,59,40,FALSE
2962,156,13,108,13,71,58,FALSE
2963,179,21,61,6,97,91,FALSE
2964,42,13,212,10,86,76,FALSE
2965,110,16,240,5,74,69,FALSE
2966,63,17,75,8,71,63,FALSE
2967,79,11,239,14,33,19,FALSE
2968,97,28,88,11,85,74,FALSE
2969,38,29,87,6,39,33,FALSE
2970,162,29,32,10,49,39,FALSE
2971,148,8,299,11,93,82,FALSE
2972,128,8,241,6,29,23,FALSE
2973,105,14,278,18,85,67,FALSE
2974,132,14,228,17,33,16,FALSE
2975,97,14,189,7,93,86,FALSE
2976,147,17,175,4,99,95,FALSE
2977,68,7,233,18,74,56,FALSE
2978,196,8,183,6,83,77,FALSE
2979,136,1,195,9,58,49,FALSE
2980,147,8,217,13,41,28,FALSE
2981,71,5,75,8,89,81,FALSE
2982,43,7,102,6,59,53,FALSE
2983,145,23,278,5,60,55,True
2984,129,11,52,16,71,55,FALSE
2985,69,26,150,16,31,15,FALSE
2986,91,15,98,10,44,34,FALSE
2987,37,30,44,3,47,44,FALSE
2988,79,10,33,6,40,34,FALSE
2989,45,14,162,7,37,30,FALSE
2990,128,26,95,15,55,40,FALSE
2991,22,2,24,11,91,80,FALSE
2992,155,21,259,16,78,62,FALSE
2993,92,28,95,15,78,63,FALSE
2994,142,24,116,10,41,31,FALSE
2995,78,13,70,5,66,61,FALSE
2996,87,27,213,16,44,28,FALSE
2997,65,18,216,1,84,83,FALSE
2998,131,6,282,5,45,40,FALSE
2999,27,10,234,15,24,9,FALSE
3000,112,23,34,20,65,45,FALSE
3001,163,10,89,1,90,89,FALSE
3002,194,10,299,8,39,31,FALSE
3003,48,11,238,12,80,68,FALSE
3004,132,17,114,2,40,38,FALSE
3005,181,13,194,14,86,72,FALSE
3006,120,18,294,19,43,24,FALSE
3007,47,23,143,16,49,33,FALSE
3008,152,15,163,15,69,54,FALSE
3009,85,21,110,2,77,75,FALSE
3010,166,30,213,7,49,42,FALSE
3011,194,18,199,2,98,96,FALSE
3012,105,17,64,7,62,55,FALSE
3013,137,4,219,7,24,17,FALSE
3014,79,6,103,8,95,87,FALSE
3015,136,18,239,20,86,66,FALSE
3016,80,29,217,18,31,13,FALSE
3017,140,29,153,20,54,34,FALSE
3018,185,5,32,12,59,47,FALSE
3019,174,23,285,20,48,28,FALSE
3020,31,17,242,8,83,75,FALSE
3021,47,22,276,12,58,46,FALSE
3022,84,4,94,6,46,40,FALSE
3023,30,17,93,17,48,31,FALSE
3024,57,11,33,18,79,61,FALSE
3025,155,6,253,15,48,33,FALSE
3026,142,22,108,11,69,58,FALSE
3027,119,7,118,4,23,19,FALSE
3028,154,28,144,12,82,70,FALSE
3029,35,30,248,7,78,71,FALSE
3030,74,8,287,3,66,63,FALSE
3031,100,29,257,7,85,78,FALSE
3032,160,3,183,3,75,72,FALSE
3033,62,11,68,10,73,63,FALSE
3034,188,24,168,17,66,49,FALSE
3035,88,3,121,6,96,90,FALSE
3036,190,9,24,10,33,23,FALSE
3037,67,26,93,13,83,70,FALSE
3038,132,19,26,3,76,73,FALSE
3039,177,13,234,12,64,52,FALSE
3040,23,29,185,2,79,77,FALSE
3041,50,8,225,5,78,73,FALSE
3042,79,5,206,6,33,27,FALSE
3043,88,23,72,3,64,61,FALSE
3044,167,8,140,16,40,24,FALSE
3045,187,4,261,15,83,68,FALSE
3046,32,10,114,4,53,49,FALSE
3047,119,2,43,1,64,63,True
3048,184,22,286,7,67,60,FALSE
3049,94,23,122,9,80,71,FALSE
3050,68,11,152,17,39,22,FALSE
3051,96,4,167,20,82,62,FALSE
3052,77,5,169,19,89,70,FALSE
3053,148,17,49,16,76,60,FALSE
3054,112,9,145,15,24,9,FALSE
3055,85,22,38,15,56,41,FALSE
3056,114,20,105,4,46,42,FALSE
3057,122,1,126,19,24,5,FALSE
3058,79,3,238,3,33,30,FALSE
3059,173,2,247,5,51,46,FALSE
3060,103,28,116,16,94,78,FALSE
3061,180,10,47,16,62,46,FALSE
3062,172,6,168,15,80,65,FALSE
3063,149,2,187,20,40,20,FALSE
3064,78,21,114,1,66,65,FALSE
3065,154,10,202,15,30,15,FALSE
3066,130,28,148,11,92,81,FALSE
3067,34,22,291,6,84,78,FALSE
3068,26,15,154,11,55,44,FALSE
3069,158,6,27,18,37,19,FALSE
3070,170,6,139,9,64,55,FALSE
3071,182,7,78,7,37,30,FALSE
3072,78,18,209,7,98,91,FALSE
3073,140,26,261,6,53,47,FALSE
3074,96,20,114,20,72,52,FALSE
3075,41,3,203,3,96,93,FALSE
3076,200,16,21,17,82,65,FALSE
3077,98,12,270,12,37,25,FALSE
3078,45,20,262,10,41,31,FALSE
3079,101,29,157,16,39,23,FALSE
3080,43,15,92,13,55,42,FALSE
3081,177,12,270,12,52,40,FALSE
3082,52,13,224,1,70,69,FALSE
3083,194,24,173,14,78,64,FALSE
3084,57,1,46,19,76,57,FALSE
3085,55,27,71,7,76,69,FALSE
3086,181,27,23,20,25,5,FALSE
3087,62,12,253,18,27,9,FALSE
3088,43,21,78,9,38,29,FALSE
3089,29,23,235,2,62,60,FALSE
3090,129,6,138,4,59,55,FALSE
3091,71,11,65,4,52,48,FALSE
3092,96,12,67,20,49,29,FALSE
3093,89,5,148,19,70,51,FALSE
3094,108,11,274,10,24,14,FALSE
3095,44,10,257,9,90,81,FALSE
3096,70,4,160,5,76,71,FALSE
3097,166,18,204,19,84,65,FALSE
3098,92,11,84,8,67,59,FALSE
3099,197,26,87,5,48,43,FALSE
3100,126,26,157,15,47,32,FALSE
3101,94,3,24,15,43,28,FALSE
3102,132,10,155,6,62,56,FALSE
3103,132,4,292,3,78,75,FALSE
3104,56,16,300,13,50,37,FALSE
3105,77,21,261,13,51,38,FALSE
3106,36,2,157,1,90,89,FALSE
3107,89,15,229,18,81,63,FALSE
3108,161,18,109,6,41,35,FALSE
3109,63,24,65,15,99,84,FALSE
3110,127,11,76,20,69,49,FALSE
3111,141,25,295,20,84,64,FALSE
3112,150,27,192,8,80,72,FALSE
3113,137,30,233,5,59,54,FALSE
3114,155,13,50,1,37,36,FALSE
3115,68,12,277,6,75,69,FALSE
3116,113,13,58,4,81,77,FALSE
3117,130,19,228,4,96,92,FALSE
3118,104,16,152,11,51,40,FALSE
3119,138,12,156,9,87,78,FALSE
3120,171,3,223,7,77,70,FALSE
3121,178,4,66,17,25,8,FALSE
3122,139,30,28,1,75,74,FALSE
3123,183,25,21,17,79,62,FALSE
3124,52,16,168,18,83,65,FALSE
3125,157,17,266,6,78,72,FALSE
3126,127,14,139,12,75,63,FALSE
3127,63,23,196,19,88,69,FALSE
3128,182,15,27,18,93,75,FALSE
3129,30,24,172,5,63,58,FALSE
3130,68,1,76,19,66,47,FALSE
3131,172,26,188,12,50,38,FALSE
3132,151,1,215,14,47,33,FALSE
3133,95,9,73,7,67,60,FALSE
3134,124,18,215,13,40,27,FALSE
3135,107,27,180,17,94,77,FALSE
3136,106,9,166,18,22,4,FALSE
3137,171,20,28,3,45,42,FALSE
3138,183,10,151,13,69,56,FALSE
3139,52,21,206,13,46,33,FALSE
3140,30,27,247,16,60,44,FALSE
3141,76,23,265,13,74,61,FALSE
3142,159,16,105,14,24,10,FALSE
3143,119,29,145,1,22,21,FALSE
3144,34,29,101,2,21,19,FALSE
3145,55,12,101,7,84,77,FALSE
3146,48,26,283,14,66,52,FALSE
3147,92,11,222,3,98,95,FALSE
3148,134,3,172,2,92,90,FALSE
3149,116,2,133,9,92,83,FALSE
3150,150,15,230,20,74,54,FALSE
3151,165,12,273,19,45,26,FALSE
3152,180,14,86,1,88,87,FALSE
3153,120,1,171,17,48,31,FALSE
3154,176,17,225,2,24,22,FALSE
3155,58,27,232,3,49,46,FALSE
3156,49,3,165,11,41,30,FALSE
3157,93,24,239,1,20,19,FALSE
3158,77,16,277,6,32,26,FALSE
3159,53,20,132,7,47,40,FALSE
3160,199,28,299,18,96,78,FALSE
3161,101,28,112,11,36,25,FALSE
3162,36,10,80,17,51,34,FALSE
3163,161,9,259,8,57,49,FALSE
3164,129,8,192,12,78,66,FALSE
3165,166,17,177,3,30,27,FALSE
3166,107,6,154,15,99,84,FALSE
3167,43,23,268,18,36,18,FALSE
3168,183,20,192,19,88,69,True
3169,59,26,278,16,52,36,FALSE
3170,128,1,35,6,76,70,FALSE
3171,98,2,173,5,72,67,FALSE
3172,143,14,85,14,87,73,FALSE
3173,199,23,44,8,75,67,FALSE
3174,132,8,239,19,74,55,FALSE
3175,102,10,165,9,68,59,FALSE
3176,76,26,247,15,58,43,FALSE
3177,127,1,110,7,34,27,FALSE
3178,133,22,230,18,79,61,FALSE
3179,136,6,146,4,68,64,FALSE
3180,140,9,25,4,69,65,FALSE
3181,90,13,210,4,75,71,FALSE
3182,67,15,152,8,56,48,FALSE
3183,184,8,168,16,23,7,FALSE
3184,73,25,250,17,99,82,FALSE
3185,41,1,116,8,59,51,FALSE
3186,32,25,153,16,23,7,FALSE
3187,180,30,213,12,31,19,FALSE
3188,51,14,213,20,20,0,FALSE
3189,20,4,211,4,70,66,True
3190,119,29,112,2,93,91,FALSE
3191,86,20,156,16,25,9,FALSE
3192,113,22,70,11,44,33,FALSE
3193,153,6,81,5,57,52,FALSE
3194,67,21,120,16,47,31,FALSE
3195,159,25,36,16,65,49,FALSE
3196,52,10,267,10,68,58,FALSE
3197,70,25,198,17,70,53,FALSE
3198,111,11,44,12,54,42,FALSE
3199,180,7,136,1,94,93,FALSE
3200,47,28,282,16,83,67,FALSE
3201,199,21,205,14,100,86,FALSE
3202,23,21,173,9,59,50,FALSE
3203,79,25,54,16,74,58,FALSE
3204,126,23,80,8,60,52,FALSE
3205,133,24,292,19,47,28,FALSE
3206,69,23,63,12,36,24,FALSE
3207,28,24,199,13,35,22,FALSE
3208,107,4,65,7,50,43,FALSE
3209,145,9,129,13,94,81,True
3210,140,11,218,8,36,28,FALSE
3211,130,19,165,19,49,30,FALSE
3212,188,14,299,9,73,64,FALSE
3213,189,25,298,8,99,91,True
3214,149,22,183,9,77,68,FALSE
3215,75,24,102,15,47,32,FALSE
3216,96,21,235,5,56,51,FALSE
3217,199,25,171,20,47,27,FALSE
3218,46,15,232,5,53,48,FALSE
3219,159,13,83,16,78,62,FALSE
3220,40,22,76,2,33,31,FALSE
3221,167,6,30,1,51,50,FALSE
3222,38,1,198,14,27,13,FALSE
3223,78,10,242,15,23,8,FALSE
3224,111,11,275,6,37,31,FALSE
3225,53,22,137,4,94,90,FALSE
3226,112,11,27,13,28,15,FALSE
3227,98,3,203,5,71,66,FALSE
3228,67,14,227,3,26,23,FALSE
3229,79,27,48,17,20,3,FALSE
3230,154,3,254,5,99,94,FALSE
3231,96,13,243,12,94,82,FALSE
3232,198,18,190,8,26,18,FALSE
3233,157,24,180,16,65,49,FALSE
3234,67,10,59,5,82,77,FALSE
3235,187,11,206,10,82,72,FALSE
3236,44,11,40,17,27,10,FALSE
3237,115,3,110,14,35,21,FALSE
3238,171,2,123,19,61,42,FALSE
3239,158,21,139,12,93,81,FALSE
3240,40,25,99,2,79,77,True
3241,94,24,52,20,64,44,FALSE
3242,109,4,95,7,98,91,FALSE
3243,146,18,291,15,30,15,FALSE
3244,123,26,225,11,91,80,FALSE
3245,200,12,29,11,33,22,FALSE
3246,171,9,58,9,67,58,FALSE
3247,157,10,228,12,63,51,FALSE
3248,166,7,122,3,68,65,FALSE
3249,43,30,237,8,21,13,FALSE
3250,157,11,192,7,77,70,FALSE
3251,36,9,164,15,73,58,FALSE
3252,194,18,100,15,99,84,FALSE
3253,61,7,133,16,78,62,FALSE
3254,46,8,285,18,79,61,FALSE
3255,172,13,236,14,70,56,FALSE
3256,54,8,61,16,97,81,FALSE
3257,112,20,60,4,61,57,FALSE
3258,199,16,82,17,51,34,FALSE
3259,37,7,242,11,68,57,FALSE
3260,167,30,244,13,81,68,FALSE
3261,127,2,241,8,35,27,FALSE
3262,193,5,174,17,28,11,FALSE
3263,151,16,183,19,52,33,FALSE
3264,150,1,186,9,98,89,FALSE
3265,190,21,25,20,90,70,FALSE
3266,31,11,163,20,80,60,FALSE
3267,195,25,57,10,62,52,True
3268,151,10,261,5,50,45,FALSE
3269,41,13,103,2,66,64,FALSE
3270,103,15,175,14,48,34,FALSE
3271,127,17,81,11,97,86,FALSE
3272,196,10,232,3,40,37,FALSE
3273,80,10,268,15,86,71,FALSE
3274,165,30,49,6,98,92,FALSE
3275,153,30,153,15,52,37,FALSE
3276,107,18,212,5,40,35,FALSE
3277,99,17,107,19,78,59,FALSE
3278,178,19,129,15,59,44,FALSE
3279,21,1,143,6,59,53,FALSE
3280,60,14,280,2,99,97,FALSE
3281,100,1,271,18,83,65,FALSE
3282,92,23,255,19,92,73,FALSE
3283,184,22,79,9,85,76,FALSE
3284,22,25,275,6,38,32,FALSE
3285,125,29,247,5,90,85,FALSE
3286,181,23,276,17,22,5,FALSE
3287,86,8,193,17,86,69,FALSE
3288,87,3,254,3,55,52,FALSE
3289,40,16,278,6,28,22,FALSE
3290,136,11,42,17,98,81,FALSE
3291,30,5,298,14,61,47,FALSE
3292,106,19,29,20,48,28,FALSE
3293,109,3,253,10,29,19,FALSE
3294,118,7,90,9,97,88,True
3295,67,14,93,19,23,4,FALSE
3296,187,12,126,6,55,49,FALSE
3297,171,5,159,11,52,41,FALSE
3298,107,19,216,4,51,47,FALSE
3299,26,28,199,9,80,71,FALSE
3300,141,17,214,3,41,38,FALSE
3301,92,6,144,19,62,43,FALSE
3302,137,1,31,15,42,27,FALSE
3303,34,6,281,20,61,41,FALSE
3304,34,27,237,9,56,47,FALSE
3305,114,18,230,14,92,78,FALSE
3306,143,13,96,8,72,64,FALSE
3307,179,26,188,20,33,13,FALSE
3308,111,28,61,10,40,30,FALSE
3309,97,23,290,15,89,74,FALSE
3310,57,14,56,8,46,38,FALSE
3311,130,1,190,4,44,40,FALSE
3312,23,3,42,10,88,78,True
3313,96,18,199,15,20,5,FALSE
3314,136,5,153,13,47,34,FALSE
3315,178,12,170,20,99,79,FALSE
3316,83,17,219,20,80,60,FALSE
3317,54,11,123,7,50,43,FALSE
3318,112,22,122,4,97,93,FALSE
3319,127,12,228,10,83,73,FALSE
3320,35,3,155,10,92,82,FALSE
3321,113,26,53,17,46,29,FALSE
3322,160,25,211,5,96,91,FALSE
3323,46,19,290,1,21,20,FALSE
3324,89,21,23,6,76,70,FALSE
3325,33,15,59,14,20,6,FALSE
3326,168,9,54,7,43,36,FALSE
3327,99,23,166,1,47,46,FALSE
3328,88,4,260,11,55,44,FALSE
3329,174,13,297,13,100,87,FALSE
3330,160,27,71,14,100,86,FALSE
3331,172,6,45,19,75,56,FALSE
3332,67,14,101,11,23,12,FALSE
3333,126,30,280,8,81,73,True
3334,164,7,196,20,90,70,FALSE
3335,121,25,58,18,95,77,FALSE
3336,191,1,125,19,28,9,FALSE
3337,134,17,185,16,94,78,FALSE
3338,173,16,196,2,89,87,FALSE
3339,166,23,92,19,94,75,FALSE
3340,169,19,48,6,51,45,FALSE
3341,188,8,253,15,54,39,FALSE
3342,56,22,84,1,22,21,FALSE
3343,20,3,30,13,39,26,FALSE
3344,145,10,95,1,90,89,FALSE
3345,25,5,196,17,60,43,FALSE
3346,151,12,173,5,97,92,FALSE
3347,54,6,182,15,81,66,FALSE
3348,125,16,76,1,56,55,FALSE
3349,138,30,72,3,83,80,FALSE
3350,83,17,73,7,26,19,FALSE
3351,88,12,149,20,74,54,FALSE
3352,104,1,24,14,25,11,FALSE
3353,33,29,225,5,80,75,FALSE
3354,181,11,42,12,36,24,FALSE
3355,104,3,233,1,25,24,FALSE
3356,53,26,138,12,97,85,FALSE
3357,43,3,41,10,91,81,FALSE
3358,108,12,216,11,75,64,FALSE
3359,74,27,239,7,36,29,FALSE
3360,63,10,155,12,31,19,FALSE
3361,29,4,176,4,87,83,FALSE
3362,121,6,95,4,98,94,FALSE
3363,177,6,61,9,65,56,FALSE
3364,49,27,244,11,99,88,FALSE
3365,30,18,36,9,28,19,FALSE
3366,29,27,45,1,38,37,FALSE
3367,143,21,131,19,30,11,FALSE
3368,43,19,270,1,95,94,FALSE
3369,59,28,168,13,76,63,FALSE
3370,43,15,160,12,99,87,FALSE
3371,37,19,149,17,21,4,FALSE
3372,136,22,120,2,24,22,FALSE
3373,94,10,241,4,23,19,FALSE
3374,82,2,159,3,47,44,True
3375,165,15,79,11,24,13,FALSE
3376,146,3,178,8,32,24,FALSE
3377,175,19,184,17,27,10,FALSE
3378,66,18,27,5,74,69,FALSE
3379,168,9,257,12,74,62,FALSE
3380,169,15,70,13,50,37,FALSE
3381,98,8,151,14,64,50,FALSE
3382,82,22,157,19,75,56,FALSE
3383,176,4,291,17,67,50,FALSE
3384,186,25,258,11,49,38,FALSE
3385,190,1,140,10,32,22,FALSE
3386,166,24,190,2,35,33,FALSE
3387,108,30,52,15,87,72,FALSE
3388,85,26,238,13,21,8,FALSE
3389,122,19,132,11,46,35,FALSE
3390,96,17,111,14,86,72,FALSE
3391,99,18,285,20,82,62,FALSE
3392,118,15,211,5,68,63,FALSE
3393,184,22,76,3,66,63,FALSE
3394,61,29,207,13,95,82,FALSE
3395,56,5,123,1,44,43,FALSE
3396,200,10,259,2,21,19,FALSE
3397,116,26,31,1,21,20,FALSE
3398,75,26,281,10,74,64,FALSE
3399,49,26,254,13,40,27,FALSE
3400,192,18,207,2,57,55,FALSE
3401,80,23,187,11,76,65,FALSE
3402,48,7,191,2,42,40,FALSE
3403,180,13,110,18,39,21,FALSE
3404,38,20,275,8,68,60,FALSE
3405,176,15,99,14,64,50,FALSE
3406,131,6,226,5,90,85,FALSE
3407,92,29,221,15,48,33,FALSE
3408,120,10,207,6,55,49,FALSE
3409,115,16,247,7,50,43,FALSE
3410,75,27,45,14,28,14,FALSE
3411,199,9,38,18,66,48,FALSE
3412,188,8,141,9,29,20,FALSE
3413,129,8,274,15,46,31,FALSE
3414,145,10,281,6,29,23,FALSE
3415,170,1,168,17,94,77,FALSE
3416,101,4,91,16,61,45,FALSE
3417,69,15,251,12,41,29,FALSE
3418,195,27,135,18,93,75,FALSE
3419,70,14,39,19,92,73,FALSE
3420,158,26,150,6,41,35,FALSE
3421,22,29,150,12,63,51,FALSE
3422,129,29,256,19,40,21,FALSE
3423,62,22,143,18,68,50,FALSE
3424,177,20,161,4,70,66,FALSE
3425,80,9,286,9,84,75,FALSE
3426,125,28,125,13,96,83,FALSE
3427,131,29,205,3,65,62,FALSE
3428,59,9,262,19,83,64,FALSE
3429,107,3,293,13,54,41,FALSE
3430,121,27,135,18,75,57,FALSE
3431,162,2,296,20,67,47,FALSE
3432,118,23,28,12,42,30,FALSE
3433,84,15,196,8,45,37,FALSE
3434,81,11,87,15,63,48,FALSE
3435,170,16,98,20,67,47,FALSE
3436,100,11,180,10,72,62,FALSE
3437,25,10,68,15,64,49,FALSE
3438,39,28,40,13,45,32,FALSE
3439,156,2,269,18,52,34,FALSE
3440,46,20,75,11,66,55,FALSE
3441,76,3,271,4,88,84,FALSE
3442,138,1,183,3,56,53,FALSE
3443,181,21,86,3,39,36,FALSE
3444,195,16,203,1,54,53,FALSE
3445,193,21,109,6,50,44,FALSE
3446,170,19,141,15,47,32,FALSE
3447,87,24,290,1,93,92,FALSE
3448,87,14,278,1,41,40,FALSE
3449,144,20,24,9,61,52,FALSE
3450,28,19,92,5,32,27,FALSE
3451,34,30,253,7,76,69,FALSE
3452,90,12,286,16,57,41,FALSE
3453,144,1,203,5,65,60,FALSE
3454,100,14,175,5,41,36,FALSE
3455,65,2,154,11,91,80,FALSE
3456,73,17,167,2,84,82,FALSE
3457,192,6,78,6,75,69,FALSE
3458,156,17,235,1,34,33,FALSE
3459,194,1,285,16,21,5,FALSE
3460,56,3,191,17,92,75,FALSE
3461,170,18,47,17,87,70,FALSE
3462,103,1,246,18,33,15,FALSE
3463,138,4,261,16,79,63,FALSE
3464,36,25,162,1,49,48,FALSE
3465,31,7,142,10,46,36,FALSE
3466,33,8,199,10,95,85,FALSE
3467,58,2,183,12,50,38,FALSE
3468,100,24,258,9,73,64,FALSE
3469,180,7,244,4,52,48,FALSE
3470,179,30,169,6,24,18,FALSE
3471,106,26,214,8,22,14,FALSE
3472,73,10,81,16,42,26,FALSE
3473,30,30,219,11,29,18,FALSE
3474,76,10,226,1,80,79,FALSE
3475,138,23,283,9,45,36,FALSE
3476,193,10,199,1,30,29,FALSE
3477,69,28,164,7,41,34,FALSE
3478,122,2,21,10,83,73,FALSE
3479,154,8,111,2,49,47,FALSE
3480,44,2,250,4,62,58,FALSE
3481,195,14,128,16,36,20,FALSE
3482,162,5,178,7,21,14,FALSE
3483,34,14,268,3,38,35,FALSE
3484,100,16,100,11,20,9,FALSE
3485,115,20,41,6,87,81,FALSE
3486,58,5,137,19,100,81,FALSE
3487,194,16,182,5,34,29,FALSE
3488,129,8,299,6,98,92,FALSE
3489,131,16,123,2,96,94,FALSE
3490,83,20,287,2,72,70,FALSE
3491,150,25,43,12,81,69,FALSE
3492,129,18,25,3,56,53,FALSE
3493,174,14,112,13,71,58,FALSE
3494,39,30,277,9,91,82,FALSE
3495,147,13,105,2,99,97,FALSE
3496,85,27,99,11,86,75,FALSE
3497,198,2,82,18,73,55,FALSE
3498,62,17,221,11,33,22,FALSE
3499,87,16,34,14,63,49,FALSE
3500,31,20,31,14,85,71,True
3501,91,15,97,1,45,44,FALSE
3502,42,20,264,2,90,88,FALSE
3503,43,18,269,17,97,80,True
3504,130,11,26,20,29,9,FALSE
3505,76,29,194,10,60,50,FALSE
3506,78,30,73,5,41,36,FALSE
3507,124,12,263,11,48,37,FALSE
3508,174,15,223,20,43,23,FALSE
3509,178,17,141,1,90,89,FALSE
3510,120,5,279,8,57,49,FALSE
3511,108,16,267,18,79,61,FALSE
3512,109,27,100,14,64,50,FALSE
3513,25,19,194,10,91,81,FALSE
3514,38,22,216,17,70,53,FALSE
3515,100,14,123,14,20,6,FALSE
3516,134,6,268,20,45,25,FALSE
3517,113,3,164,1,95,94,FALSE
3518,169,15,161,9,90,81,FALSE
3519,143,22,112,10,33,23,FALSE
3520,152,24,91,10,78,68,FALSE
3521,50,9,199,13,97,84,FALSE
3522,172,5,127,4,42,38,FALSE
3523,179,15,38,12,34,22,FALSE
3524,197,18,89,11,81,70,FALSE
3525,88,21,294,7,79,72,FALSE
3526,41,3,253,9,33,24,FALSE
3527,101,21,175,19,21,2,FALSE
3528,100,23,279,8,79,71,FALSE
3529,195,27,84,10,47,37,FALSE
3530,173,22,284,8,84,76,FALSE
3531,86,25,33,11,33,22,FALSE
3532,90,14,199,8,20,12,FALSE
3533,108,25,45,14,82,68,FALSE
3534,106,1,199,2,20,18,FALSE
3535,169,27,135,4,30,26,FALSE
3536,116,27,64,12,78,66,FALSE
3537,152,28,291,14,86,72,FALSE
3538,160,14,71,17,34,17,FALSE
3539,129,10,202,1,41,40,FALSE
3540,159,17,149,20,61,41,True
3541,99,1,166,8,63,55,FALSE
3542,194,4,47,7,44,37,FALSE
3543,174,11,105,9,53,44,FALSE
3544,182,22,120,13,67,54,FALSE
3545,40,29,300,5,91,86,FALSE
3546,92,1,167,9,32,23,FALSE
3547,129,30,212,10,35,25,FALSE
3548,147,22,151,18,69,51,FALSE
3549,80,1,189,4,71,67,FALSE
3550,171,8,210,7,43,36,FALSE
3551,156,19,140,11,85,74,FALSE
3552,104,9,122,2,47,45,FALSE
3553,106,2,64,7,40,33,FALSE
3554,66,8,222,16,39,23,FALSE
3555,23,18,139,18,91,73,FALSE
3556,134,2,294,2,54,52,FALSE
3557,54,13,238,11,43,32,FALSE
3558,191,3,284,12,94,82,FALSE
3559,20,28,43,7,86,79,FALSE
3560,164,3,115,1,54,53,FALSE
3561,24,12,206,3,84,81,FALSE
3562,37,2,164,5,94,89,FALSE
3563,181,9,221,17,51,34,FALSE
3564,159,22,283,5,37,32,FALSE
3565,75,24,272,1,32,31,FALSE
3566,148,30,164,3,56,53,FALSE
3567,200,30,27,3,64,61,FALSE
3568,143,25,213,9,40,31,FALSE
3569,149,8,236,8,59,51,FALSE
3570,36,9,38,3,64,61,FALSE
3571,29,23,272,16,95,79,FALSE
3572,104,22,175,1,73,72,FALSE
3573,29,18,122,9,67,58,FALSE
3574,93,12,222,13,76,63,FALSE
3575,86,26,58,14,39,25,FALSE
3576,40,23,123,12,69,57,FALSE
3577,66,30,282,5,45,40,FALSE
3578,53,22,75,18,24,6,FALSE
3579,164,28,119,12,29,17,FALSE
3580,61,26,121,16,85,69,FALSE
3581,57,29,100,11,32,21,FALSE
3582,141,6,180,12,56,44,FALSE
3583,199,12,281,11,70,59,FALSE
3584,93,7,32,10,86,76,FALSE
3585,146,2,115,18,32,14,FALSE
3586,28,23,279,15,61,46,FALSE
3587,140,8,277,19,98,79,FALSE
3588,147,29,295,7,63,56,FALSE
3589,154,18,58,8,94,86,FALSE
3590,95,14,76,8,84,76,FALSE
3591,74,21,214,9,83,74,FALSE
3592,105,6,300,3,85,82,FALSE
3593,91,3,257,2,41,39,FALSE
3594,113,25,245,4,99,95,FALSE
3595,97,8,157,18,52,34,FALSE
3596,68,11,273,12,26,14,True
3597,143,27,187,3,69,66,FALSE
3598,117,9,266,20,56,36,FALSE
3599,113,10,82,8,37,29,FALSE
3600,97,24,232,15,33,18,FALSE
3601,74,6,225,12,79,67,FALSE
3602,117,29,20,1,55,54,FALSE
3603,122,26,160,11,26,15,FALSE
3604,33,3,31,3,78,75,FALSE
3605,109,15,177,9,97,88,FALSE
3606,43,13,58,13,55,42,FALSE
3607,159,7,163,9,44,35,FALSE
3608,39,3,241,1,50,49,FALSE
3609,200,24,235,2,23,21,FALSE
3610,179,9,74,16,66,50,FALSE
3611,174,11,57,17,94,77,FALSE
3612,142,24,288,10,77,67,FALSE
3613,22,18,159,8,74,66,FALSE
3614,43,19,235,3,67,64,FALSE
3615,89,22,241,9,50,41,FALSE
3616,46,26,241,10,46,36,True
3617,166,5,151,4,79,75,FALSE
3618,63,22,193,8,71,63,FALSE
3619,182,19,146,9,65,56,FALSE
3620,122,3,280,20,39,19,FALSE
3621,26,18,197,20,96,76,FALSE
3622,121,1,202,12,73,61,FALSE
3623,138,21,249,1,35,34,FALSE
3624,137,17,130,4,23,19,FALSE
3625,182,1,196,12,70,58,FALSE
3626,104,19,296,6,95,89,FALSE
3627,139,19,245,14,81,67,FALSE
3628,78,19,102,18,79,61,FALSE
3629,181,15,201,3,43,40,FALSE
3630,161,24,197,4,42,38,FALSE
3631,195,13,117,14,47,33,FALSE
3632,148,6,112,5,36,31,FALSE
3633,80,24,142,13,37,24,FALSE
3634,25,8,295,13,54,41,FALSE
3635,83,1,69,20,52,32,FALSE
3636,37,14,227,9,94,85,FALSE
3637,163,13,261,19,38,19,FALSE
3638,103,30,20,16,75,59,FALSE
3639,39,4,42,2,97,95,FALSE
3640,59,29,108,15,77,62,FALSE
3641,81,29,238,9,31,22,FALSE
3642,194,27,196,4,57,53,FALSE
3643,61,23,131,18,60,42,FALSE
3644,141,14,153,6,62,56,FALSE
3645,142,17,51,20,27,7,FALSE
3646,46,10,92,12,43,31,FALSE
3647,23,7,190,8,89,81,FALSE
3648,153,5,103,7,77,70,FALSE
3649,83,9,174,5,95,90,FALSE
3650,179,6,218,13,88,75,FALSE
3651,52,7,94,8,63,55,FALSE
3652,91,9,146,12,57,45,FALSE
3653,170,15,238,8,99,91,FALSE
3654,139,18,63,14,49,35,FALSE
3655,102,17,60,5,87,82,FALSE
3656,92,12,234,18,63,45,FALSE
3657,113,12,35,17,45,28,FALSE
3658,172,2,295,6,69,63,FALSE
3659,44,24,47,4,20,16,FALSE
3660,137,28,32,20,87,67,FALSE
3661,135,8,197,4,72,68,FALSE
3662,152,2,97,13,42,29,FALSE
3663,65,29,25,16,87,71,FALSE
3664,40,23,87,14,66,52,FALSE
3665,169,26,253,17,84,67,FALSE
3666,43,18,26,17,37,20,FALSE
3667,139,27,99,16,97,81,FALSE
3668,129,27,279,8,29,21,FALSE
3669,28,3,170,3,85,82,FALSE
3670,105,14,206,17,52,35,FALSE
3671,44,23,90,10,33,23,FALSE
3672,111,22,80,14,27,13,FALSE
3673,191,6,159,4,58,54,FALSE
3674,63,26,238,4,22,18,FALSE
3675,71,16,222,19,77,58,FALSE
3676,121,10,292,18,57,39,True
3677,152,16,57,1,27,26,FALSE
3678,157,26,60,4,37,33,FALSE
3679,73,5,208,13,20,7,FALSE
3680,89,20,51,15,53,38,FALSE
3681,105,5,135,17,23,6,FALSE
3682,135,12,77,11,47,36,FALSE
3683,104,6,116,9,62,53,FALSE
3684,29,26,144,11,95,84,FALSE
3685,33,9,25,9,85,76,FALSE
3686,123,29,143,16,70,54,FALSE
3687,57,20,136,10,95,85,FALSE
3688,145,10,35,6,100,94,FALSE
3689,58,14,96,6,66,60,FALSE
3690,26,24,195,1,47,46,FALSE
3691,51,27,39,1,56,55,FALSE
3692,95,4,266,4,96,92,FALSE
3693,72,26,44,19,31,12,FALSE
3694,156,6,89,2,34,32,FALSE
3695,87,29,234,11,100,89,FALSE
3696,56,29,152,13,57,44,FALSE
3697,132,7,290,12,70,58,FALSE
3698,83,25,210,12,71,59,FALSE
3699,109,26,262,5,81,76,FALSE
3700,156,24,92,12,60,48,FALSE
3701,102,10,27,11,49,38,FALSE
3702,188,13,242,6,93,87,FALSE
3703,186,26,199,20,97,77,FALSE
3704,94,12,276,18,51,33,FALSE
3705,128,20,85,12,67,55,FALSE
3706,111,2,270,14,46,32,FALSE
3707,173,24,238,4,87,83,FALSE
3708,58,1,174,2,85,83,FALSE
3709,65,11,59,17,50,33,FALSE
3710,91,29,182,7,21,14,FALSE
3711,83,11,82,6,42,36,FALSE
3712,91,25,170,7,65,58,FALSE
3713,56,5,33,17,50,33,FALSE
3714,154,3,123,15,88,73,FALSE
3715,122,1,51,9,34,25,FALSE
3716,48,8,199,7,56,49,FALSE
3717,119,11,299,20,55,35,FALSE
3718,66,6,118,13,44,31,FALSE
3719,162,18,169,15,43,28,FALSE
3720,139,22,55,17,99,82,FALSE
3721,25,23,213,17,100,83,FALSE
3722,52,13,44,18,84,66,FALSE
3723,25,2,58,7,38,31,FALSE
3724,145,1,69,2,24,22,FALSE
3725,85,23,176,18,27,9,FALSE
3726,53,29,154,7,62,55,FALSE
3727,115,18,275,14,65,51,FALSE
3728,35,3,210,7,82,75,FALSE
3729,75,10,279,7,52,45,FALSE
3730,142,8,228,3,82,79,FALSE
3731,128,29,286,13,78,65,FALSE
3732,110,12,295,11,49,38,True
3733,135,6,243,18,66,48,FALSE
3734,104,17,97,1,79,78,FALSE
3735,157,9,232,15,40,25,FALSE
3736,133,13,255,4,96,92,FALSE
3737,187,29,257,19,81,62,FALSE
3738,79,25,80,13,78,65,FALSE
3739,192,16,138,6,36,30,FALSE
3740,27,22,273,7,21,14,FALSE
3741,181,19,292,9,36,27,FALSE
3742,79,4,294,17,51,34,FALSE
3743,158,12,291,7,35,28,FALSE
3744,90,18,236,1,46,45,FALSE
3745,191,12,82,6,33,27,FALSE
3746,43,5,33,13,55,42,FALSE
3747,147,3,117,3,76,73,FALSE
3748,108,30,131,1,51,50,FALSE
3749,169,16,31,12,55,43,FALSE
3750,135,7,118,3,90,87,FALSE
3751,188,18,264,19,78,59,FALSE
3752,38,26,87,17,55,38,FALSE
3753,93,21,130,14,35,21,FALSE
3754,124,5,168,8,34,26,FALSE
3755,76,11,74,16,71,55,FALSE
3756,31,4,53,4,57,53,FALSE
3757,70,10,276,9,89,80,FALSE
3758,99,29,82,19,65,46,FALSE
3759,93,25,226,10,88,78,FALSE
3760,63,13,290,19,28,9,FALSE
3761,78,26,49,11,95,84,True
3762,80,23,93,9,54,45,FALSE
3763,141,19,51,12,81,69,FALSE
3764,124,3,116,17,48,31,FALSE
3765,48,11,155,3,24,21,FALSE
3766,25,28,119,11,75,64,FALSE
3767,70,9,300,9,96,87,FALSE
3768,67,16,160,20,89,69,FALSE
3769,80,6,246,4,55,51,True
3770,52,26,105,7,64,57,FALSE
3771,189,21,43,20,38,18,FALSE
3772,74,9,29,15,36,21,FALSE
3773,77,11,208,1,29,28,FALSE
3774,102,23,149,16,66,50,FALSE
3775,108,4,257,5,39,34,FALSE
3776,152,2,110,4,62,58,FALSE
3777,72,9,106,5,82,77,FALSE
3778,169,10,97,7,67,60,FALSE
3779,95,10,122,10,62,52,FALSE
3780,120,25,237,2,60,58,FALSE
3781,98,23,282,2,62,60,FALSE
3782,129,14,105,14,26,12,FALSE
3783,199,10,268,16,78,62,FALSE
3784,67,14,232,2,79,77,FALSE
3785,159,5,245,3,87,84,FALSE
3786,98,12,28,9,61,52,FALSE
3787,134,12,186,6,77,71,True
3788,129,18,27,5,85,80,FALSE
3789,79,8,279,17,39,22,FALSE
3790,89,9,59,1,35,34,FALSE
3791,160,15,262,16,40,24,FALSE
3792,127,12,274,3,98,95,FALSE
3793,89,1,201,16,98,82,True
3794,170,8,228,5,86,81,FALSE
3795,172,4,93,16,29,13,FALSE
3796,153,10,103,13,83,70,FALSE
3797,83,25,94,2,65,63,FALSE
3798,120,2,22,13,37,24,FALSE
3799,167,28,250,19,27,8,FALSE
3800,55,1,258,18,61,43,FALSE
3801,62,8,151,7,87,80,FALSE
3802,154,20,177,1,36,35,FALSE
3803,141,28,120,5,61,56,FALSE
3804,139,30,89,2,90,88,FALSE
3805,161,2,214,16,24,8,FALSE
3806,68,4,177,12,100,88,FALSE
3807,30,10,41,12,96,84,FALSE
3808,63,16,208,8,59,51,FALSE
3809,199,1,133,9,25,16,FALSE
3810,133,15,63,7,56,49,FALSE
3811,130,27,142,13,52,39,FALSE
3812,104,7,257,8,87,79,FALSE
3813,71,27,278,16,50,34,FALSE
3814,87,26,151,2,98,96,FALSE
3815,193,25,276,11,47,36,FALSE
3816,171,21,49,15,80,65,FALSE
3817,89,15,184,16,89,73,FALSE
3818,169,16,232,7,44,37,FALSE
3819,112,21,131,4,21,17,FALSE
3820,20,17,22,2,52,50,FALSE
3821,190,6,41,10,25,15,FALSE
3822,194,12,194,13,44,31,FALSE
3823,71,23,274,5,21,16,FALSE
3824,175,15,258,13,41,28,FALSE
3825,40,18,71,7,36,29,FALSE
3826,59,19,198,17,59,42,FALSE
3827,89,26,217,16,27,11,FALSE
3828,61,21,135,20,45,25,FALSE
3829,88,30,163,17,59,42,FALSE
3830,184,25,188,8,21,13,FALSE
3831,31,18,84,12,62,50,FALSE
3832,156,5,259,1,51,50,FALSE
3833,110,15,189,5,78,73,FALSE
3834,117,28,26,15,43,28,FALSE
3835,42,8,267,7,48,41,FALSE
3836,191,11,137,11,84,73,FALSE
3837,199,29,109,12,62,50,FALSE
3838,44,2,65,4,28,24,FALSE
3839,200,20,132,17,37,20,FALSE
3840,47,26,62,1,32,31,FALSE
3841,67,18,205,14,33,19,FALSE
3842,198,27,279,20,61,41,FALSE
3843,189,12,154,15,68,53,FALSE
3844,27,29,87,8,29,21,FALSE
3845,82,24,286,13,81,68,FALSE
3846,20,4,238,16,26,10,FALSE
3847,147,26,102,9,49,40,FALSE
3848,61,4,21,12,47,35,FALSE
3849,91,22,248,19,98,79,FALSE
3850,184,8,126,9,56,47,FALSE
3851,122,2,259,8,80,72,FALSE
3852,21,14,251,16,86,70,FALSE
3853,46,16,198,13,33,20,FALSE
3854,33,1,119,16,39,23,FALSE
3855,117,19,123,20,30,10,FALSE
3856,35,1,137,8,24,16,FALSE
3857,191,16,241,18,71,53,FALSE
3858,136,13,41,13,60,47,FALSE
3859,150,8,144,11,86,75,FALSE
3860,114,6,44,3,87,84,FALSE
3861,111,17,196,14,62,48,FALSE
3862,31,9,230,14,85,71,FALSE
3863,191,1,150,7,68,61,FALSE
3864,119,27,116,20,29,9,FALSE
3865,47,16,73,14,75,61,FALSE
3866,153,12,136,10,38,28,FALSE
3867,48,6,145,12,51,39,FALSE
3868,64,8,153,4,43,39,FALSE
3869,64,13,126,8,33,25,True
3870,157,12,220,14,68,54,FALSE
3871,122,25,191,13,97,84,FALSE
3872,73,25,54,17,53,36,FALSE
3873,73,28,272,16,45,29,FALSE
3874,52,22,120,9,41,32,FALSE
3875,86,9,291,14,58,44,FALSE
3876,49,2,292,14,33,19,FALSE
3877,123,14,70,13,85,72,FALSE
3878,62,11,114,1,90,89,FALSE
3879,106,13,206,2,79,77,FALSE
3880,33,6,279,10,97,87,FALSE
3881,57,2,128,10,51,41,FALSE
3882,91,28,230,16,43,27,FALSE
3883,181,9,55,10,99,89,FALSE
3884,37,28,21,19,78,59,FALSE
3885,80,18,292,3,58,55,FALSE
3886,143,19,63,10,71,61,FALSE
3887,93,20,238,6,70,64,FALSE
3888,110,10,104,11,59,48,FALSE
3889,69,24,86,10,26,16,FALSE
3890,39,8,263,9,87,78,FALSE
3891,128,20,225,8,60,52,True
3892,75,22,289,4,65,61,FALSE
3893,140,7,83,9,73,64,FALSE
3894,118,22,157,20,61,41,FALSE
3895,154,11,292,12,40,28,FALSE
3896,141,28,51,12,81,69,FALSE
3897,83,7,146,12,46,34,FALSE
3898,66,29,141,12,92,80,FALSE
3899,114,28,121,18,67,49,FALSE
3900,47,9,60,1,72,71,FALSE
3901,158,26,66,14,63,49,FALSE
3902,192,2,207,20,84,64,FALSE
3903,138,4,110,2,93,91,FALSE
3904,121,4,121,14,81,67,FALSE
3905,24,8,143,11,26,15,FALSE
3906,145,5,116,20,51,31,FALSE
3907,33,11,54,2,29,27,FALSE
3908,86,3,153,14,77,63,FALSE
3909,34,29,230,16,73,57,FALSE
3910,120,21,73,10,60,50,FALSE
3911,143,13,179,2,35,33,FALSE
3912,198,16,245,14,71,57,FALSE
3913,25,15,210,8,86,78,FALSE
3914,67,6,246,2,21,19,FALSE
3915,155,29,111,18,47,29,FALSE
3916,88,22,84,4,95,91,FALSE
3917,61,2,49,10,53,43,FALSE
3918,53,29,31,7,52,45,FALSE
3919,129,7,45,11,98,87,FALSE
3920,123,2,100,5,27,22,FALSE
3921,169,10,141,17,97,80,FALSE
3922,110,7,216,9,34,25,FALSE
3923,132,16,260,1,76,75,FALSE
3924,146,30,189,20,57,37,FALSE
3925,69,8,150,11,50,39,FALSE
3926,37,2,200,17,61,44,FALSE
3927,105,17,186,13,41,28,FALSE
3928,25,22,86,10,47,37,FALSE
3929,124,9,60,14,21,7,FALSE
3930,41,23,105,7,78,71,FALSE
3931,55,3,39,16,52,36,FALSE
3932,80,14,289,2,82,80,FALSE
3933,80,17,203,2,29,27,FALSE
3934,132,8,73,18,45,27,FALSE
3935,200,1,300,12,81,69,FALSE
3936,126,4,224,14,27,13,FALSE
3937,46,23,84,11,84,73,FALSE
3938,181,5,228,6,20,14,FALSE
3939,109,21,113,13,57,44,FALSE
3940,151,13,285,16,52,36,FALSE
3941,127,21,234,20,37,17,FALSE
3942,103,7,117,1,82,81,FALSE
3943,175,23,100,3,36,33,FALSE
3944,126,3,22,6,29,23,FALSE
3945,153,28,146,5,79,74,FALSE
3946,147,29,230,3,46,43,FALSE
3947,101,23,214,18,79,61,FALSE
3948,160,30,284,3,77,74,FALSE
3949,43,14,178,3,64,61,FALSE
3950,30,24,176,20,24,4,FALSE
3951,111,21,115,14,92,78,FALSE
3952,85,29,166,20,35,15,FALSE
3953,80,8,70,16,51,35,FALSE
3954,179,20,198,7,78,71,True
3955,186,1,82,9,100,91,FALSE
3956,155,15,150,5,94,89,FALSE
3957,66,13,219,17,25,8,FALSE
3958,136,14,148,4,44,40,FALSE
3959,112,3,36,8,86,78,FALSE
3960,22,5,212,10,71,61,FALSE
3961,39,20,44,5,75,70,FALSE
3962,23,29,178,14,88,74,FALSE
3963,179,7,20,15,36,21,FALSE
3964,76,27,159,19,38,19,FALSE
3965,47,1,278,9,65,56,FALSE
3966,23,28,48,9,93,84,FALSE
3967,130,7,79,9,57,48,FALSE
3968,153,11,34,13,89,76,FALSE
3969,91,16,62,19,34,15,True
3970,184,2,163,4,37,33,FALSE
3971,147,20,252,17,59,42,FALSE
3972,192,30,266,10,22,12,FALSE
3973,33,3,179,8,45,37,FALSE
3974,35,15,26,1,45,44,FALSE
3975,191,18,273,3,30,27,FALSE
3976,158,3,180,18,41,23,FALSE
3977,188,10,27,10,83,73,FALSE
3978,87,15,151,19,36,17,FALSE
3979,117,23,57,1,56,55,FALSE
3980,98,20,83,5,54,49,FALSE
3981,96,4,134,6,63,57,FALSE
3982,147,2,120,2,35,33,FALSE
3983,55,4,168,13,40,27,FALSE
3984,32,20,36,19,74,55,FALSE
3985,95,21,52,18,57,39,FALSE
3986,20,30,258,7,56,49,FALSE
3987,47,22,197,19,92,73,FALSE
3988,47,27,30,17,64,47,FALSE
3989,87,6,134,12,85,73,FALSE
3990,102,12,161,20,43,23,FALSE
3991,110,19,204,19,43,24,FALSE
3992,88,3,61,11,43,32,FALSE
3993,149,11,287,3,94,91,FALSE
3994,50,10,51,12,74,62,FALSE
3995,165,4,218,13,23,10,FALSE
3996,116,2,266,8,49,41,FALSE
3997,193,15,259,15,39,24,FALSE
3998,62,9,43,3,75,72,FALSE
3999,109,24,69,7,91,84,FALSE
4000,67,27,103,11,53,42,FALSE
4001,32,21,207,5,46,41,FALSE
4002,168,4,28,11,98,87,FALSE
4003,20,14,193,11,80,69,FALSE
4004,151,7,265,20,26,6,FALSE
4005,147,10,85,15,21,6,FALSE
4006,190,24,67,10,28,18,FALSE
4007,167,25,203,15,68,53,FALSE
4008,52,9,194,6,79,73,FALSE
4009,70,3,213,5,70,65,FALSE
4010,171,25,74,18,30,12,FALSE
4011,53,7,281,12,59,47,FALSE
4012,91,11,282,8,45,37,FALSE
4013,70,9,182,8,34,26,FALSE
4014,128,3,23,9,42,33,FALSE
4015,166,29,235,3,48,45,FALSE
4016,176,27,196,19,100,81,FALSE
4017,153,3,291,13,86,73,FALSE
4018,37,6,189,1,62,61,FALSE
4019,150,14,253,13,95,82,FALSE
4020,64,14,106,14,51,37,FALSE
4021,156,6,75,9,41,32,FALSE
4022,124,14,244,8,94,86,True
4023,100,14,79,17,40,23,FALSE
4024,90,12,58,10,100,90,FALSE
4025,131,20,103,1,51,50,FALSE
4026,95,11,159,4,68,64,FALSE
4027,157,29,78,8,59,51,FALSE
4028,132,5,165,8,84,76,True
4029,87,17,40,20,23,3,FALSE
4030,192,1,56,5,62,57,FALSE
4031,120,18,161,11,67,56,FALSE
4032,159,7,291,9,66,57,True
4033,161,23,194,15,89,74,FALSE
4034,22,8,229,11,26,15,FALSE
4035,159,16,203,1,27,26,FALSE
4036,81,7,222,15,60,45,FALSE
4037,23,11,110,8,33,25,FALSE
4038,26,1,83,12,29,17,True
4039,193,25,162,1,36,35,FALSE
4040,24,21,56,3,97,94,FALSE
4041,41,28,116,20,88,68,FALSE
4042,71,17,140,8,55,47,FALSE
4043,176,13,229,17,26,9,FALSE
4044,115,6,30,3,63,60,FALSE
4045,143,17,143,7,91,84,FALSE
4046,133,11,49,8,77,69,FALSE
4047,35,6,209,13,47,34,FALSE
4048,195,27,206,1,48,47,FALSE
4049,88,22,298,10,52,42,FALSE
4050,182,1,152,19,100,81,FALSE
4051,66,22,114,6,23,17,FALSE
4052,61,28,140,5,41,36,FALSE
4053,147,25,107,16,97,81,FALSE
4054,116,2,79,15,99,84,FALSE
4055,40,20,102,9,83,74,FALSE
4056,52,3,111,13,30,17,FALSE
4057,147,11,259,4,55,51,FALSE
4058,117,18,151,13,20,7,FALSE
4059,88,28,194,5,95,90,FALSE
4060,195,19,52,5,28,23,FALSE
4061,119,10,63,10,44,34,FALSE
4062,98,6,87,3,73,70,FALSE
4063,168,3,85,12,20,8,FALSE
4064,188,5,230,12,65,53,FALSE
4065,110,11,127,4,47,43,FALSE
4066,178,9,300,20,65,45,FALSE
4067,120,14,93,14,78,64,FALSE
4068,114,6,211,17,73,56,FALSE
4069,85,10,270,1,40,39,FALSE
4070,46,18,59,16,50,34,FALSE
4071,122,18,299,10,52,42,FALSE
4072,31,10,263,14,35,21,FALSE
4073,67,21,141,19,37,18,FALSE
4074,110,16,52,8,91,83,FALSE
4075,66,25,261,12,67,55,FALSE
4076,141,7,98,18,66,48,FALSE
4077,138,9,195,1,43,42,FALSE
4078,153,2,172,11,25,14,FALSE
4079,53,20,27,14,97,83,FALSE
4080,200,28,185,4,37,33,FALSE
4081,110,18,225,10,66,56,FALSE
4082,184,27,256,16,76,60,FALSE
4083,78,3,149,20,38,18,True
4084,137,18,206,1,56,55,FALSE
4085,158,9,75,10,71,61,True
4086,64,24,42,3,39,36,FALSE
4087,139,26,206,9,20,11,True
4088,98,30,54,1,59,58,FALSE
4089,198,14,39,18,95,77,FALSE
4090,178,5,235,14,62,48,FALSE
4091,143,27,20,14,94,80,FALSE
4092,107,5,277,2,84,82,FALSE
4093,199,17,32,3,34,31,FALSE
4094,162,29,124,3,70,67,FALSE
4095,175,6,49,5,77,72,FALSE
4096,97,7,139,14,22,8,FALSE
4097,166,5,63,6,97,91,FALSE
4098,144,7,58,19,30,11,FALSE
4099,100,6,252,1,51,50,FALSE
4100,122,2,36,17,76,59,FALSE
4101,118,30,229,5,62,57,FALSE
4102,89,26,196,11,26,15,True
4103,153,25,102,5,73,68,FALSE
4104,173,9,189,2,23,21,FALSE
4105,34,20,48,9,38,29,FALSE
4106,34,7,35,12,67,55,FALSE
4107,95,17,202,5,58,53,FALSE
4108,35,22,25,13,80,67,FALSE
4109,153,22,40,12,34,22,FALSE
4110,166,10,59,10,71,61,FALSE
4111,160,20,204,13,65,52,FALSE
4112,108,10,112,7,23,16,FALSE
4113,63,6,292,19,48,29,FALSE
4114,193,23,195,12,60,48,FALSE
4115,94,29,197,12,52,40,FALSE
4116,43,16,179,12,63,51,FALSE
4117,21,23,133,18,25,7,FALSE
4118,60,15,54,4,37,33,FALSE
4119,112,30,300,14,89,75,FALSE
4120,62,5,171,11,51,40,FALSE
4121,73,28,267,15,49,34,FALSE
4122,47,12,66,20,62,42,FALSE
4123,174,20,157,3,97,94,FALSE
4124,141,18,71,10,57,47,FALSE
4125,147,6,235,8,27,19,FALSE
4126,97,2,201,18,53,35,FALSE
4127,109,15,38,13,28,15,FALSE
4128,44,3,25,14,57,43,FALSE
4129,97,27,189,14,59,45,FALSE
4130,156,25,268,17,29,12,FALSE
4131,134,9,219,18,96,78,FALSE
4132,143,13,23,10,95,85,FALSE
4133,160,22,287,15,40,25,FALSE
4134,22,13,210,19,29,10,FALSE
4135,20,18,177,7,95,88,FALSE
4136,71,5,189,16,26,10,FALSE
4137,175,30,187,10,82,72,FALSE
4138,181,1,180,9,26,17,FALSE
4139,51,2,115,13,76,63,FALSE
4140,35,2,124,11,25,14,FALSE
4141,152,29,124,8,66,58,FALSE
4142,158,16,142,2,35,33,FALSE
4143,77,22,182,19,41,22,FALSE
4144,159,19,50,11,38,27,FALSE
4145,174,6,289,5,22,17,FALSE
4146,193,13,88,10,73,63,FALSE
4147,46,12,284,19,61,42,FALSE
4148,84,6,137,15,65,50,FALSE
4149,125,20,213,13,97,84,FALSE
4150,22,10,174,16,48,32,FALSE
4151,108,20,253,6,33,27,FALSE
4152,59,30,94,12,94,82,FALSE
4153,66,23,235,20,41,21,FALSE
4154,122,3,236,10,88,78,FALSE
4155,70,30,200,12,46,34,FALSE
4156,183,17,292,10,44,34,FALSE
4157,121,4,120,15,64,49,FALSE
4158,178,26,242,16,89,73,FALSE
4159,153,21,37,12,33,21,FALSE
4160,127,12,78,7,81,74,FALSE
4161,200,26,212,16,53,37,FALSE
4162,171,15,280,10,53,43,FALSE
4163,71,17,139,8,25,17,FALSE
4164,126,24,194,13,78,65,FALSE
4165,174,10,181,6,48,42,FALSE
4166,113,2,113,4,83,79,FALSE
4167,31,29,164,17,35,18,FALSE
4168,82,15,108,4,84,80,FALSE
4169,86,14,282,16,30,14,FALSE
4170,165,27,142,19,82,63,FALSE
4171,164,28,297,14,39,25,FALSE
4172,198,18,181,7,42,35,FALSE
4173,148,13,106,1,36,35,FALSE
4174,189,27,238,18,24,6,FALSE
4175,139,21,135,14,57,43,FALSE
4176,24,24,150,8,52,44,FALSE
4177,38,13,271,10,93,83,FALSE
4178,187,28,264,2,65,63,FALSE
4179,158,19,282,13,98,85,FALSE
4180,76,8,274,12,53,41,FALSE
4181,114,19,140,7,32,25,FALSE
4182,173,3,154,12,44,32,FALSE
4183,52,7,238,2,90,88,FALSE
4184,195,14,21,14,57,43,FALSE
4185,108,14,23,19,81,62,FALSE
4186,43,21,176,17,86,69,FALSE
4187,172,13,41,15,52,37,FALSE
4188,197,24,48,14,77,63,FALSE
4189,177,3,38,11,30,19,FALSE
4190,145,17,260,12,44,32,FALSE
4191,195,11,31,7,70,63,FALSE
4192,148,22,291,11,29,18,FALSE
4193,32,17,235,11,51,40,FALSE
4194,165,11,241,14,91,77,FALSE
4195,138,27,39,4,42,38,FALSE
4196,90,30,66,17,52,35,FALSE
4197,123,17,216,16,38,22,FALSE
4198,179,16,211,6,80,74,FALSE
4199,167,4,95,10,59,49,FALSE
4200,42,24,119,8,77,69,FALSE
4201,144,10,248,19,41,22,FALSE
4202,133,11,27,20,58,38,FALSE
4203,185,7,222,19,96,77,True
4204,69,2,190,4,39,35,FALSE
4205,60,10,216,17,25,8,FALSE
4206,147,3,197,13,46,33,FALSE
4207,172,2,20,12,66,54,FALSE
4208,129,3,172,17,88,71,FALSE
4209,185,10,198,12,51,39,FALSE
4210,71,11,274,3,72,69,FALSE
4211,173,10,210,2,38,36,FALSE
4212,154,16,37,13,58,45,FALSE
4213,166,5,86,3,29,26,FALSE
4214,130,29,173,4,61,57,FALSE
4215,128,22,292,1,68,67,FALSE
4216,136,17,43,15,65,50,FALSE
4217,31,14,94,14,61,47,FALSE
4218,69,24,68,10,59,49,FALSE
4219,102,25,106,4,21,17,FALSE
4220,185,9,141,17,50,33,FALSE
4221,74,4,239,17,82,65,FALSE
4222,163,15,57,3,60,57,FALSE
4223,93,26,82,10,44,34,FALSE
4224,141,29,154,12,28,16,FALSE
4225,93,20,286,12,92,80,FALSE
4226,110,20,279,14,88,74,FALSE
4227,91,12,20,1,35,34,FALSE
4228,141,23,224,18,69,51,FALSE
4229,93,19,210,5,87,82,FALSE
4230,53,3,58,10,38,28,FALSE
4231,126,19,137,19,20,1,FALSE
4232,32,12,219,13,90,77,FALSE
4233,75,22,238,14,41,27,FALSE
4234,86,18,234,16,48,32,FALSE
4235,138,24,85,7,64,57,FALSE
4236,200,28,38,15,57,42,FALSE
4237,167,23,145,4,54,50,FALSE
4238,85,20,72,7,56,49,FALSE
4239,50,19,113,12,95,83,FALSE
4240,130,25,188,5,42,37,FALSE
4241,68,7,212,3,43,40,FALSE
4242,87,23,216,4,67,63,FALSE
4243,72,11,35,9,77,68,FALSE
4244,184,14,148,4,58,54,FALSE
4245,137,30,253,10,70,60,FALSE
4246,23,9,248,20,29,9,FALSE
4247,25,18,243,5,57,52,FALSE
4248,176,27,96,3,93,90,FALSE
4249,57,2,108,9,78,69,FALSE
4250,141,2,292,13,30,17,FALSE
4251,170,19,267,15,34,19,FALSE
4252,195,6,112,7,46,39,FALSE
4253,193,24,230,14,43,29,FALSE
4254,180,1,129,5,82,77,FALSE
4255,159,16,198,1,72,71,FALSE
4256,57,19,98,17,25,8,FALSE
4257,109,30,212,10,34,24,FALSE
4258,193,10,44,4,93,89,FALSE
4259,53,23,234,15,24,9,FALSE
4260,174,22,291,9,80,71,FALSE
4261,100,26,198,13,20,7,FALSE
4262,88,23,284,3,62,59,FALSE
4263,142,26,124,7,62,55,FALSE
4264,111,30,79,13,55,42,True
4265,99,29,194,18,27,9,FALSE
4266,136,26,234,14,99,85,FALSE
4267,35,27,164,9,24,15,FALSE
4268,103,4,99,10,93,83,FALSE
4269,154,19,260,11,89,78,FALSE
4270,64,30,60,4,97,93,FALSE
4271,113,3,206,12,27,15,FALSE
4272,152,17,246,7,83,76,FALSE
4273,80,11,134,9,47,38,FALSE
4274,62,10,174,14,77,63,FALSE
4275,112,25,108,4,91,87,FALSE
4276,119,14,192,17,76,59,True
4277,28,14,70,8,78,70,FALSE
4278,26,22,271,4,100,96,FALSE
4279,52,25,252,16,26,10,FALSE
4280,175,23,269,10,73,63,FALSE
4281,69,18,55,9,69,60,FALSE
4282,81,1,106,16,100,84,FALSE
4283,118,1,224,11,99,88,FALSE
4284,195,8,142,9,61,52,FALSE
4285,157,7,158,9,33,24,FALSE
4286,67,11,102,5,50,45,FALSE
4287,63,4,265,18,74,56,FALSE
4288,195,27,210,8,74,66,FALSE
4289,74,4,193,11,56,45,FALSE
4290,154,23,279,12,24,12,FALSE
4291,121,26,93,19,54,35,FALSE
4292,167,20,75,7,81,74,FALSE
4293,119,1,85,9,24,15,FALSE
4294,87,5,281,15,73,58,FALSE
4295,27,23,279,1,24,23,FALSE
4296,94,2,90,1,75,74,FALSE
4297,132,9,33,1,68,67,FALSE
4298,100,6,236,2,83,81,FALSE
4299,174,7,256,15,40,25,FALSE
4300,44,5,217,7,30,23,FALSE
4301,198,3,81,9,77,68,FALSE
4302,34,3,249,5,63,58,FALSE
4303,186,13,280,12,42,30,FALSE
4304,72,16,93,19,26,7,FALSE
4305,181,23,160,15,24,9,FALSE
4306,135,1,278,8,76,68,FALSE
4307,192,11,265,19,74,55,FALSE
4308,43,29,220,15,41,26,True
4309,126,8,265,18,97,79,FALSE
4310,125,20,119,18,26,8,FALSE
4311,121,13,32,8,87,79,FALSE
4312,171,11,58,20,97,77,FALSE
4313,190,16,55,19,97,78,FALSE
4314,196,19,49,1,44,43,FALSE
4315,73,16,242,14,90,76,FALSE
4316,170,15,204,4,52,48,FALSE
4317,28,26,22,12,61,49,FALSE
4318,156,23,56,3,39,36,FALSE
4319,138,16,53,8,100,92,FALSE
4320,74,14,127,8,84,76,FALSE
4321,77,26,213,10,41,31,FALSE
4322,136,2,254,7,94,87,FALSE
4323,27,16,75,16,39,23,FALSE
4324,149,24,214,1,32,31,FALSE
4325,165,12,202,15,69,54,FALSE
4326,79,20,173,7,53,46,FALSE
4327,89,30,48,9,83,74,FALSE
4328,92,24,227,10,28,18,FALSE
4329,116,30,185,15,77,62,FALSE
4330,35,8,106,15,66,51,FALSE
4331,39,2,27,8,65,57,FALSE
4332,170,6,162,7,65,58,FALSE
4333,104,7,191,15,78,63,FALSE
4334,134,10,146,16,41,25,FALSE
4335,87,30,125,19,28,9,FALSE
4336,129,5,97,12,20,8,FALSE
4337,192,17,224,10,77,67,FALSE
4338,86,4,281,12,63,51,FALSE
4339,160,11,125,3,29,26,FALSE
4340,75,5,164,3,91,88,FALSE
4341,114,6,235,8,84,76,FALSE
4342,102,26,111,12,22,10,FALSE
4343,36,29,102,16,58,42,FALSE
4344,138,5,215,3,81,78,FALSE
4345,140,11,228,12,99,87,FALSE
4346,120,18,189,7,59,52,FALSE
4347,103,23,264,15,21,6,FALSE
4348,84,29,134,18,21,3,FALSE
4349,99,25,83,13,53,40,FALSE
4350,23,29,230,18,82,64,FALSE
4351,187,23,136,8,35,27,FALSE
4352,43,23,142,5,71,66,FALSE
4353,165,8,152,13,37,24,FALSE
4354,122,8,44,15,49,34,FALSE
4355,99,25,223,2,26,24,FALSE
4356,46,16,89,12,43,31,FALSE
4357,53,14,263,8,75,67,FALSE
4358,59,10,48,2,59,57,FALSE
4359,81,3,88,7,33,26,FALSE
4360,23,6,112,18,89,71,FALSE
4361,36,10,235,3,99,96,FALSE
4362,93,18,51,2,61,59,FALSE
4363,136,20,271,18,24,6,FALSE
4364,40,22,153,19,25,6,FALSE
4365,119,27,292,9,95,86,FALSE
4366,123,17,241,9,35,26,FALSE
4367,181,5,152,15,62,47,FALSE
4368,116,4,271,10,38,28,FALSE
4369,139,16,269,10,77,67,FALSE
4370,153,10,43,8,74,66,FALSE
4371,174,30,297,6,33,27,FALSE
4372,141,18,171,6,73,67,FALSE
4373,24,19,254,19,50,31,FALSE
4374,113,8,138,18,99,81,FALSE
4375,23,16,297,14,87,73,FALSE
4376,139,22,175,6,88,82,FALSE
4377,93,4,71,13,59,46,FALSE
4378,48,11,146,5,74,69,FALSE
4379,178,14,231,1,20,19,FALSE
4380,71,26,52,1,26,25,FALSE
4381,198,12,208,8,51,43,FALSE
4382,23,28,230,15,23,8,FALSE
4383,158,2,71,7,55,48,FALSE
4384,56,21,116,7,27,20,FALSE
4385,79,24,242,5,92,87,FALSE
4386,142,29,65,14,41,27,FALSE
4387,108,7,132,11,68,57,FALSE
4388,99,11,296,9,85,76,FALSE
4389,104,21,63,15,100,85,FALSE
4390,138,23,101,2,21,19,FALSE
4391,23,29,113,6,54,48,FALSE
4392,61,10,267,14,54,40,FALSE
4393,161,8,158,5,43,38,FALSE
4394,64,28,245,6,35,29,FALSE
4395,81,28,29,9,90,81,FALSE
4396,196,4,50,20,87,67,FALSE
4397,160,22,136,4,84,80,FALSE
4398,126,11,276,4,24,20,FALSE
4399,176,7,32,15,28,13,FALSE
4400,76,12,213,17,36,19,FALSE
4401,102,25,28,8,28,20,True
4402,86,27,88,8,55,47,FALSE
4403,200,3,284,13,92,79,FALSE
4404,151,19,168,17,41,24,FALSE
4405,159,19,112,20,54,34,FALSE
4406,42,6,262,10,77,67,FALSE
4407,21,25,40,15,92,77,True
4408,179,17,53,15,32,17,FALSE
4409,121,25,157,7,33,26,FALSE
4410,32,26,289,11,59,48,FALSE
4411,176,27,180,11,89,78,FALSE
4412,126,3,290,1,57,56,FALSE
4413,106,24,142,5,36,31,FALSE
4414,158,24,288,5,40,35,FALSE
4415,129,13,21,11,43,32,FALSE
4416,113,6,156,15,42,27,FALSE
4417,117,20,175,4,20,16,FALSE
4418,168,8,124,18,69,51,FALSE
4419,143,12,118,10,50,40,FALSE
4420,78,3,134,15,60,45,FALSE
4421,96,18,253,4,67,63,FALSE
4422,186,17,287,7,39,32,FALSE
4423,157,21,182,9,33,24,FALSE
4424,54,29,68,9,66,57,FALSE
4425,61,3,229,7,86,79,FALSE
4426,52,26,242,19,97,78,FALSE
4427,163,9,237,2,74,72,FALSE
4428,153,23,26,13,50,37,FALSE
4429,176,21,244,13,69,56,FALSE
4430,158,19,106,17,50,33,FALSE
4431,122,11,208,7,57,50,FALSE
4432,135,20,235,2,59,57,FALSE
4433,100,5,285,8,52,44,FALSE
4434,63,6,265,3,84,81,FALSE
4435,93,7,121,10,89,79,FALSE
4436,40,2,45,14,45,31,FALSE
4437,154,27,57,3,59,56,FALSE
4438,170,19,261,7,95,88,FALSE
4439,120,18,84,19,27,8,FALSE
4440,85,12,170,3,42,39,FALSE
4441,56,17,243,8,42,34,FALSE
4442,42,3,211,15,98,83,FALSE
4443,116,10,136,18,30,12,FALSE
4444,20,17,269,7,93,86,FALSE
4445,39,2,120,2,89,87,FALSE
4446,77,29,47,2,43,41,FALSE
4447,165,10,194,20,88,68,FALSE
4448,26,10,237,7,60,53,FALSE
4449,49,14,259,14,90,76,FALSE
4450,49,19,217,9,83,74,FALSE
4451,87,25,215,5,86,81,FALSE
4452,154,8,225,16,37,21,FALSE
4453,65,29,94,4,71,67,FALSE
4454,74,19,41,9,59,50,FALSE
4455,41,17,88,8,42,34,FALSE
4456,69,10,264,18,55,37,FALSE
4457,28,11,151,15,48,33,FALSE
4458,100,26,146,7,71,64,FALSE
4459,65,30,141,10,63,53,FALSE
4460,65,7,172,1,93,92,FALSE
4461,189,19,173,11,35,24,FALSE
4462,56,14,71,12,74,62,FALSE
4463,26,29,113,18,99,81,FALSE
4464,197,29,39,1,30,29,FALSE
4465,29,25,263,6,69,63,FALSE
4466,189,9,164,11,35,24,FALSE
4467,94,13,100,7,75,68,FALSE
4468,38,15,207,4,20,16,FALSE
4469,69,17,137,9,51,42,FALSE
4470,71,1,92,3,92,89,FALSE
4471,127,6,112,7,87,80,FALSE
4472,173,17,101,20,42,22,FALSE
4473,111,3,271,14,58,44,FALSE
4474,72,17,70,1,92,91,FALSE
4475,74,23,76,11,53,42,FALSE
4476,171,10,251,3,100,97,FALSE
4477,73,15,148,20,92,72,FALSE
4478,27,21,234,10,76,66,FALSE
4479,32,17,83,5,24,19,True
4480,135,19,174,7,41,34,FALSE
4481,74,6,108,9,22,13,FALSE
4482,38,18,281,7,29,22,FALSE
4483,41,5,85,17,62,45,FALSE
4484,195,21,137,2,39,37,FALSE
4485,64,17,57,15,63,48,FALSE
4486,134,2,42,11,52,41,FALSE
4487,41,8,228,8,28,20,FALSE
4488,73,12,228,4,21,17,FALSE
4489,185,3,225,8,75,67,FALSE
4490,56,9,172,5,45,40,FALSE
4491,157,12,246,15,99,84,FALSE
4492,73,22,185,5,92,87,FALSE
4493,20,1,220,11,73,62,FALSE
4494,181,4,37,20,22,2,FALSE
4495,35,10,107,2,86,84,FALSE
4496,47,19,266,6,57,51,True
4497,188,14,152,12,65,53,FALSE
4498,56,4,165,19,84,65,FALSE
4499,102,23,300,5,20,15,FALSE
4500,79,11,217,13,21,8,FALSE
4501,80,14,160,10,94,84,FALSE
4502,104,30,137,20,39,19,FALSE
4503,89,17,63,12,41,29,FALSE
4504,135,25,35,6,81,75,FALSE
4505,106,27,20,8,95,87,FALSE
4506,113,27,41,4,37,33,True
4507,146,1,240,5,100,95,FALSE
4508,200,16,78,19,44,25,FALSE
4509,172,29,201,16,90,74,FALSE
4510,35,19,191,14,84,70,FALSE
4511,50,16,291,11,46,35,FALSE
4512,73,14,229,12,77,65,FALSE
4513,191,9,219,2,37,35,FALSE
4514,96,1,294,10,80,70,FALSE
4515,71,13,119,14,76,62,FALSE
4516,196,19,300,16,74,58,FALSE
4517,148,26,282,13,38,25,FALSE
4518,42,1,109,1,52,51,FALSE
4519,163,16,288,18,91,73,True
4520,34,28,55,20,87,67,FALSE
4521,183,10,64,12,57,45,FALSE
4522,192,30,268,6,61,55,FALSE
4523,124,19,271,11,45,34,FALSE
4524,63,29,242,16,92,76,FALSE
4525,150,10,101,16,77,61,FALSE
4526,172,13,187,2,90,88,FALSE
4527,141,12,109,1,29,28,FALSE
4528,49,10,191,1,23,22,FALSE
4529,36,21,42,5,53,48,FALSE
4530,146,18,27,18,96,78,FALSE
4531,73,12,173,15,65,50,FALSE
4532,155,20,44,11,72,61,FALSE
4533,40,14,296,12,87,75,FALSE
4534,33,15,122,9,27,18,FALSE
4535,136,9,117,7,48,41,FALSE
4536,153,7,234,13,29,16,FALSE
4537,183,29,243,7,75,68,FALSE
4538,165,5,119,4,89,85,FALSE
4539,88,6,111,19,87,68,FALSE
4540,75,26,220,7,90,83,FALSE
4541,65,22,203,2,34,32,FALSE
4542,47,26,246,13,28,15,FALSE
4543,177,22,225,4,50,46,FALSE
4544,118,28,95,15,32,17,FALSE
4545,151,3,241,15,60,45,FALSE
4546,142,5,164,18,67,49,FALSE
4547,181,22,83,14,96,82,FALSE
4548,25,22,58,11,46,35,FALSE
4549,47,3,221,9,85,76,FALSE
4550,91,8,251,13,49,36,FALSE
4551,181,21,254,7,48,41,FALSE
4552,50,9,202,11,84,73,FALSE
4553,31,23,177,16,23,7,FALSE
4554,73,23,94,1,63,62,FALSE
4555,172,21,277,9,34,25,FALSE
4556,198,1,266,1,70,69,FALSE
4557,86,5,243,4,94,90,FALSE
4558,99,10,201,16,98,82,FALSE
4559,96,23,277,20,57,37,FALSE
4560,67,19,258,2,94,92,FALSE
4561,75,7,58,17,61,44,FALSE
4562,30,1,77,14,82,68,FALSE
4563,107,24,183,2,67,65,FALSE
4564,182,18,251,20,33,13,FALSE
4565,165,7,56,20,20,0,FALSE
4566,61,11,65,14,49,35,FALSE
4567,187,4,190,10,29,19,FALSE
4568,64,11,291,14,27,13,FALSE
4569,121,12,220,8,43,35,FALSE
4570,124,28,273,15,74,59,FALSE
4571,99,26,270,11,78,67,FALSE
4572,25,4,95,10,94,84,FALSE
4573,90,14,83,7,21,14,FALSE
4574,105,3,225,2,20,18,FALSE
4575,41,9,63,4,49,45,FALSE
4576,53,27,211,2,99,97,FALSE
4577,194,15,124,15,80,65,FALSE
4578,178,19,248,20,80,60,FALSE
4579,148,29,85,11,42,31,FALSE
4580,119,18,279,12,71,59,FALSE
4581,148,17,54,6,45,39,FALSE
4582,165,5,120,15,74,59,FALSE
4583,186,27,79,17,78,61,FALSE
4584,177,5,69,4,55,51,FALSE
4585,68,22,266,16,90,74,FALSE
4586,178,11,190,10,28,18,FALSE
4587,106,12,167,14,50,36,FALSE
4588,39,19,97,5,41,36,FALSE
4589,37,3,39,12,56,44,FALSE
4590,32,18,186,12,80,68,FALSE
4591,104,5,59,15,70,55,FALSE
4592,70,12,189,16,28,12,FALSE
4593,155,2,284,9,55,46,FALSE
4594,44,29,221,12,35,23,FALSE
4595,37,4,124,17,54,37,FALSE
4596,86,25,296,6,61,55,FALSE
4597,138,4,162,13,95,82,FALSE
4598,95,20,179,17,52,35,FALSE
4599,64,11,68,12,37,25,FALSE
4600,200,24,136,9,68,59,FALSE
4601,143,27,153,9,73,64,FALSE
4602,66,29,102,20,76,56,FALSE
4603,185,6,117,9,79,70,FALSE
4604,141,4,97,8,81,73,FALSE
4605,74,15,179,10,77,67,FALSE
4606,31,2,279,18,66,48,FALSE
4607,111,4,274,7,33,26,FALSE
4608,62,4,44,1,79,78,FALSE
4609,185,23,222,2,43,41,FALSE
4610,86,27,265,8,100,92,FALSE
4611,132,3,194,5,48,43,FALSE
4612,60,12,147,16,99,83,FALSE
4613,168,8,189,7,91,84,FALSE
4614,20,3,198,3,47,44,FALSE
4615,89,8,272,15,83,68,FALSE
4616,112,22,34,15,44,29,FALSE
4617,70,15,109,4,87,83,FALSE
4618,127,20,133,3,38,35,FALSE
4619,81,29,105,17,95,78,FALSE
4620,75,22,299,7,26,19,FALSE
4621,91,8,119,11,94,83,FALSE
4622,22,2,283,6,85,79,FALSE
4623,112,28,134,4,62,58,FALSE
4624,56,1,259,2,42,40,FALSE
4625,181,4,193,18,39,21,FALSE
4626,119,2,151,2,23,21,FALSE
4627,149,5,58,3,55,52,FALSE
4628,112,18,269,17,29,12,FALSE
4629,68,13,256,19,55,36,FALSE
4630,139,25,272,19,83,64,FALSE
4631,195,1,164,19,75,56,FALSE
4632,98,25,272,4,78,74,FALSE
4633,137,17,267,5,31,26,FALSE
4634,38,27,257,17,75,58,FALSE
4635,129,25,143,15,95,80,FALSE
4636,24,24,57,11,23,12,FALSE
4637,87,9,32,11,35,24,FALSE
4638,61,8,102,9,88,79,FALSE
4639,187,29,72,1,22,21,True
4640,37,29,100,16,60,44,FALSE
4641,76,25,56,7,88,81,FALSE
4642,197,20,230,18,69,51,FALSE
4643,56,12,148,20,20,0,FALSE
4644,81,27,195,6,31,25,FALSE
4645,47,18,287,4,98,94,FALSE
4646,155,23,262,9,61,52,FALSE
4647,72,12,24,17,47,30,FALSE
4648,190,25,173,19,67,48,FALSE
4649,36,17,237,2,31,29,FALSE
4650,35,4,123,3,43,40,FALSE
4651,141,16,164,1,55,54,FALSE
4652,26,30,232,9,37,28,FALSE
4653,177,26,192,17,61,44,FALSE
4654,117,27,50,7,73,66,FALSE
4655,46,26,205,1,55,54,FALSE
4656,199,6,110,10,84,74,FALSE
4657,140,28,112,20,24,4,FALSE
4658,103,13,182,9,67,58,FALSE
4659,134,2,183,6,28,22,FALSE
4660,104,11,166,4,26,22,FALSE
4661,50,21,68,3,66,63,FALSE
4662,194,19,71,14,53,39,FALSE
4663,189,25,103,12,23,11,FALSE
4664,157,11,117,9,23,14,FALSE
4665,194,2,255,18,100,82,FALSE
4666,73,9,275,6,84,78,FALSE
4667,35,8,70,4,43,39,FALSE
4668,102,15,291,2,34,32,FALSE
4669,139,4,48,10,84,74,FALSE
4670,75,25,176,11,30,19,FALSE
4671,121,27,167,20,54,34,FALSE
4672,31,29,70,17,58,41,FALSE
4673,40,18,234,12,73,61,FALSE
4674,102,29,70,9,57,48,FALSE
4675,124,1,241,5,98,93,FALSE
4676,96,14,73,5,32,27,FALSE
4677,158,15,33,13,25,12,FALSE
4678,193,2,158,15,37,22,FALSE
4679,183,7,179,4,93,89,FALSE
4680,77,22,181,1,30,29,FALSE
4681,111,16,157,17,35,18,FALSE
4682,97,8,124,18,60,42,FALSE
4683,147,7,41,9,65,56,FALSE
4684,105,5,116,8,83,75,FALSE
4685,52,4,43,18,57,39,FALSE
4686,71,1,172,2,88,86,FALSE
4687,97,8,233,17,63,46,FALSE
4688,140,19,162,16,94,78,FALSE
4689,170,21,236,16,94,78,FALSE
4690,128,30,192,10,29,19,True
4691,78,26,215,3,54,51,FALSE
4692,85,16,89,12,67,55,FALSE
4693,124,17,83,10,93,83,FALSE
4694,196,18,175,16,92,76,FALSE
4695,172,18,183,12,59,47,FALSE
4696,77,5,66,6,32,26,FALSE
4697,99,27,203,4,88,84,FALSE
4698,73,30,133,20,71,51,FALSE
4699,200,7,148,3,95,92,FALSE
4700,104,20,198,15,23,8,FALSE
4701,112,6,153,12,41,29,FALSE
4702,138,23,286,6,77,71,FALSE
4703,26,2,237,17,28,11,FALSE
4704,193,1,139,13,88,75,FALSE
4705,118,20,233,3,20,17,FALSE
4706,36,2,142,15,43,28,FALSE
4707,113,3,38,17,93,76,FALSE
4708,34,19,47,17,37,20,FALSE
4709,124,22,261,16,54,38,FALSE
4710,22,4,86,8,41,33,FALSE
4711,157,27,101,1,64,63,FALSE
4712,35,26,208,12,61,49,FALSE
4713,197,1,291,11,90,79,FALSE
4714,40,24,186,14,55,41,FALSE
4715,132,9,245,11,95,84,FALSE
4716,133,28,89,9,31,22,FALSE
4717,80,7,51,18,68,50,FALSE
4718,181,6,20,11,27,16,FALSE
4719,141,10,56,9,61,52,FALSE
4720,132,14,287,13,44,31,FALSE
4721,134,18,264,18,78,60,FALSE
4722,116,8,40,14,96,82,FALSE
4723,55,18,250,7,62,55,FALSE
4724,163,21,222,10,57,47,FALSE
4725,110,17,27,17,95,78,FALSE
4726,193,21,262,4,27,23,FALSE
4727,175,27,102,15,60,45,FALSE
4728,64,12,248,20,60,40,FALSE
4729,144,2,178,12,77,65,FALSE
4730,98,17,197,1,61,60,FALSE
4731,127,22,272,15,58,43,FALSE
4732,104,22,293,8,95,87,FALSE
4733,99,27,199,19,22,3,FALSE
4734,182,14,65,11,77,66,FALSE
4735,179,18,132,18,58,40,FALSE
4736,46,18,115,8,92,84,FALSE
4737,84,5,185,15,86,71,FALSE
4738,132,30,138,18,40,22,FALSE
4739,164,16,255,17,73,56,FALSE
4740,35,21,22,10,22,12,FALSE
4741,200,12,218,4,35,31,FALSE
4742,80,15,111,2,61,59,FALSE
4743,181,4,222,2,26,24,FALSE
4744,68,28,75,17,62,45,FALSE
4745,145,26,54,1,24,23,FALSE
4746,65,20,287,17,98,81,FALSE
4747,144,11,275,11,32,21,FALSE
4748,168,20,166,11,66,55,FALSE
4749,45,1,78,6,46,40,FALSE
4750,176,23,65,3,99,96,FALSE
4751,118,19,203,5,71,66,FALSE
4752,58,9,239,12,75,63,FALSE
4753,146,6,238,9,72,63,FALSE
4754,61,9,52,10,64,54,FALSE
4755,118,13,283,4,67,63,FALSE
4756,123,20,41,7,29,22,FALSE
4757,200,11,246,16,83,67,FALSE
4758,191,5,187,3,98,95,FALSE
4759,118,29,278,5,68,63,FALSE
4760,78,4,208,12,49,37,FALSE
4761,164,26,167,6,20,14,FALSE
4762,151,5,104,4,89,85,FALSE
4763,111,26,293,10,88,78,FALSE
4764,168,5,100,15,81,66,FALSE
4765,62,3,153,14,78,64,FALSE
4766,101,8,177,5,43,38,FALSE
4767,60,23,300,6,37,31,FALSE
4768,141,7,33,20,48,28,FALSE
4769,81,27,199,15,67,52,FALSE
4770,93,27,32,5,83,78,FALSE
4771,162,15,205,3,79,76,FALSE
4772,159,22,59,7,42,35,True
4773,177,27,232,8,80,72,FALSE
4774,51,18,27,4,46,42,FALSE
4775,90,22,172,20,59,39,FALSE
4776,194,8,248,1,84,83,FALSE
4777,181,16,221,19,43,24,FALSE
4778,30,15,237,14,46,32,FALSE
4779,143,11,224,18,32,14,FALSE
4780,74,2,277,10,100,90,FALSE
4781,191,9,125,20,77,57,FALSE
4782,145,8,141,2,69,67,FALSE
4783,84,2,250,1,96,95,FALSE
4784,122,11,153,6,96,90,FALSE
4785,56,14,45,16,69,53,FALSE
4786,161,28,171,16,24,8,FALSE
4787,158,10,83,9,92,83,FALSE
4788,145,7,124,1,76,75,FALSE
4789,155,8,52,13,35,22,FALSE
4790,53,20,299,16,76,60,FALSE
4791,187,26,153,1,52,51,True
4792,48,16,48,2,37,35,FALSE
4793,74,30,90,4,94,90,FALSE
4794,200,15,251,7,26,19,FALSE
4795,166,8,126,18,29,11,FALSE
4796,49,27,51,9,59,50,True
4797,79,5,85,15,97,82,FALSE
4798,61,13,192,5,21,16,FALSE
4799,148,15,35,14,25,11,FALSE
4800,158,10,270,14,100,86,FALSE
4801,42,24,41,18,70,52,FALSE
4802,166,5,246,14,69,55,FALSE
4803,72,3,99,13,26,13,FALSE
4804,131,20,106,3,50,47,FALSE
4805,139,22,240,15,39,24,FALSE
4806,147,18,131,6,42,36,True
4807,37,8,63,18,67,49,FALSE
4808,43,11,71,20,79,59,FALSE
4809,101,1,297,8,88,80,FALSE
4810,117,5,217,9,65,56,FALSE
4811,115,8,221,5,80,75,FALSE
4812,57,3,87,11,27,16,FALSE
4813,140,27,204,19,92,73,FALSE
4814,61,25,28,10,73,63,FALSE
4815,139,24,56,7,76,69,FALSE
4816,141,22,273,1,38,37,FALSE
4817,57,15,107,20,28,8,FALSE
4818,106,8,26,16,90,74,FALSE
4819,174,12,261,14,45,31,FALSE
4820,125,26,93,17,55,38,FALSE
4821,173,21,78,15,79,64,FALSE
4822,168,17,145,14,99,85,FALSE
4823,187,21,219,17,91,74,FALSE
4824,119,27,249,15,36,21,FALSE
4825,92,26,158,18,27,9,FALSE
4826,55,7,266,17,58,41,FALSE
4827,70,17,201,12,84,72,FALSE
4828,186,25,73,17,90,73,FALSE
4829,90,24,222,3,47,44,FALSE
4830,141,13,191,9,62,53,FALSE
4831,153,4,294,11,22,11,FALSE
4832,111,4,44,9,62,53,FALSE
4833,49,19,282,3,52,49,FALSE
4834,175,10,210,20,24,4,FALSE
4835,139,5,39,8,27,19,FALSE
4836,38,24,88,3,61,58,FALSE
4837,176,3,69,7,58,51,FALSE
4838,71,11,109,3,29,26,FALSE
4839,137,5,164,12,93,81,FALSE
4840,121,20,287,4,77,73,FALSE
4841,154,20,184,5,94,89,FALSE
4842,108,27,268,9,24,15,FALSE
4843,64,10,213,11,54,43,FALSE
4844,147,13,298,6,73,67,FALSE
4845,194,19,295,17,83,66,FALSE
4846,75,3,103,4,76,72,FALSE
4847,26,22,220,4,31,27,FALSE
4848,145,4,186,5,65,60,FALSE
4849,88,3,186,2,42,40,FALSE
4850,34,11,187,19,73,54,FALSE
4851,39,14,37,10,87,77,True
4852,121,24,283,10,43,33,FALSE
4853,178,11,206,6,37,31,FALSE
4854,170,22,54,1,75,74,FALSE
4855,192,16,177,2,95,93,FALSE
4856,41,5,146,9,21,12,FALSE
4857,91,6,184,4,53,49,FALSE
4858,20,10,67,13,63,50,FALSE
4859,192,8,298,11,32,21,FALSE
4860,39,26,226,18,49,31,FALSE
4861,61,8,229,6,80,74,FALSE
4862,196,8,190,17,55,38,FALSE
4863,175,6,121,6,67,61,FALSE
4864,162,3,191,17,73,56,FALSE
4865,24,22,149,14,41,27,FALSE
4866,49,13,71,10,72,62,FALSE
4867,46,11,212,9,89,80,FALSE
4868,169,12,62,6,95,89,FALSE
4869,148,8,73,8,99,91,FALSE
4870,28,21,224,13,98,85,FALSE
4871,149,30,81,15,90,75,FALSE
4872,52,25,289,15,56,41,FALSE
4873,145,9,222,8,30,22,FALSE
4874,143,7,122,12,60,48,FALSE
4875,33,15,103,5,59,54,FALSE
4876,97,20,83,13,32,19,FALSE
4877,163,28,76,10,88,78,FALSE
4878,131,4,103,14,76,62,FALSE
4879,54,26,91,2,57,55,FALSE
4880,119,26,94,17,55,38,True
4881,169,1,212,2,33,31,FALSE
4882,75,8,124,9,60,51,FALSE
4883,41,19,136,9,60,51,FALSE
4884,125,11,109,15,89,74,FALSE
4885,51,10,99,2,54,52,FALSE
4886,59,10,265,10,69,59,FALSE
4887,168,30,262,8,28,20,FALSE
4888,58,22,135,14,87,73,FALSE
4889,94,29,82,2,32,30,FALSE
4890,140,2,163,4,52,48,FALSE
4891,180,19,144,10,21,11,FALSE
4892,88,25,280,13,49,36,FALSE
4893,176,29,243,18,86,68,FALSE
4894,129,8,193,7,60,53,FALSE
4895,107,22,162,6,52,46,FALSE
4896,113,10,123,5,60,55,FALSE
4897,183,11,226,8,50,42,FALSE
4898,25,23,237,1,92,91,FALSE
4899,106,15,22,7,73,66,FALSE
4900,173,21,163,18,49,31,FALSE
4901,29,12,146,13,46,33,FALSE
4902,150,26,64,5,90,85,FALSE
4903,113,26,255,3,37,34,FALSE
4904,117,26,215,20,77,57,FALSE
4905,40,27,183,15,40,25,FALSE
4906,84,17,238,7,95,88,FALSE
4907,184,1,242,8,41,33,FALSE
4908,43,8,210,3,58,55,FALSE
4909,38,3,143,17,48,31,FALSE
4910,168,28,193,1,81,80,FALSE
4911,63,13,54,9,100,91,FALSE
4912,154,23,192,2,95,93,FALSE
4913,68,1,73,13,47,34,FALSE
4914,143,4,171,13,46,33,FALSE
4915,196,11,131,11,62,51,FALSE
4916,59,15,151,11,60,49,True
4917,93,12,79,15,29,14,FALSE
4918,97,27,117,3,71,68,FALSE
4919,172,20,107,20,77,57,FALSE
4920,25,5,289,11,77,66,FALSE
4921,85,10,159,7,50,43,FALSE
4922,35,26,46,19,69,50,FALSE
4923,59,5,78,15,76,61,FALSE
4924,79,1,202,1,68,67,FALSE
4925,187,6,21,15,84,69,FALSE
4926,23,27,40,6,98,92,FALSE
4927,173,23,76,9,30,21,FALSE
4928,29,9,189,1,26,25,FALSE
4929,92,27,156,7,89,82,FALSE
4930,184,17,139,4,46,42,FALSE
4931,152,8,109,8,79,71,FALSE
4932,75,30,62,7,91,84,FALSE
4933,123,20,217,2,76,74,FALSE
4934,137,10,157,7,52,45,FALSE
4935,122,8,157,13,71,58,FALSE
4936,127,26,31,1,36,35,FALSE
4937,75,6,297,15,40,25,FALSE
4938,186,22,93,8,33,25,True
4939,191,15,297,18,82,64,FALSE
4940,130,13,55,13,29,16,FALSE
4941,172,20,197,15,78,63,FALSE
4942,189,26,148,13,39,26,FALSE
4943,74,19,236,20,80,60,FALSE
4944,97,24,112,6,88,82,FALSE
4945,101,19,23,10,68,58,FALSE
4946,108,24,183,18,70,52,FALSE
4947,157,21,74,4,74,70,FALSE
4948,180,15,104,12,79,67,FALSE
4949,88,30,105,1,32,31,FALSE
4950,29,26,132,12,23,11,FALSE
4951,61,8,208,16,25,9,FALSE
4952,24,21,179,18,24,6,FALSE
4953,44,1,73,18,56,38,FALSE
4954,48,21,28,20,31,11,FALSE
4955,101,2,98,4,27,23,FALSE
4956,23,21,158,9,92,83,FALSE
4957,64,3,110,2,56,54,FALSE
4958,145,5,166,10,46,36,FALSE
4959,48,28,223,13,62,49,FALSE
4960,187,2,166,6,47,41,FALSE
4961,118,21,81,17,40,23,FALSE
4962,25,5,162,13,89,76,FALSE
4963,94,29,223,16,42,26,FALSE
4964,67,5,173,20,88,68,True
4965,54,18,254,4,83,79,FALSE
4966,46,23,287,10,74,64,FALSE
4967,142,4,214,19,76,57,FALSE
4968,145,20,75,14,81,67,FALSE
4969,177,21,108,16,55,39,FALSE
4970,184,1,191,2,50,48,FALSE
4971,132,27,165,2,59,57,FALSE
4972,182,14,30,20,59,39,FALSE
4973,56,27,118,11,37,26,FALSE
4974,191,15,286,9,96,87,FALSE
4975,76,6,126,12,22,10,FALSE
4976,154,18,127,8,35,27,FALSE
4977,153,21,43,18,28,10,FALSE
4978,40,14,234,13,48,35,FALSE
4979,64,23,230,16,92,76,FALSE
4980,79,5,159,17,87,70,FALSE
4981,32,24,239,11,21,10,FALSE
4982,155,1,221,13,29,16,FALSE
4983,149,12,81,5,24,19,FALSE
4984,115,13,157,20,59,39,FALSE
4985,31,3,105,9,22,13,FALSE
4986,87,20,65,16,70,54,FALSE
4987,193,1,105,10,40,30,FALSE
4988,159,28,21,16,26,10,FALSE
4989,153,26,291,14,56,42,FALSE
4990,81,24,182,14,28,14,FALSE
4991,34,12,56,17,80,63,FALSE
4992,161,10,85,15,28,13,FALSE
4993,26,25,174,5,33,28,FALSE
4994,73,12,262,16,44,28,FALSE
4995,167,20,252,10,76,66,FALSE
4996,170,8,128,11,36,25,FALSE
4997,158,15,51,19,82,63,FALSE
4998,21,12,136,2,67,65,FALSE
4999,61,28,137,20,20,0,FALSE
5000,176,5,282,13,80,67,FALSE
5001,166,24,200,14,21,7,FALSE
5002,59,6,221,16,21,5,FALSE
5003,151,4,109,17,53,36,FALSE
5004,134,2,137,4,52,48,FALSE
5005,36,24,269,12,79,67,FALSE
5006,142,24,225,5,76,71,FALSE
5007,34,28,231,5,64,59,FALSE
5008,89,10,172,2,20,18,FALSE
5009,31,18,119,7,73,66,FALSE
5010,114,21,264,11,30,19,FALSE
5011,182,13,37,1,34,33,FALSE
5012,83,2,217,7,83,76,FALSE
5013,186,7,45,11,60,49,True
5014,97,15,221,15,98,83,FALSE
5015,100,12,152,16,89,73,FALSE
5016,134,8,194,6,86,80,FALSE
5017,136,14,259,17,26,9,FALSE
5018,137,18,45,8,86,78,FALSE
5019,169,6,214,12,20,8,FALSE
5020,62,27,69,9,37,28,FALSE
5021,109,9,53,3,83,80,FALSE
5022,96,4,52,19,27,8,FALSE
5023,92,7,235,1,24,23,FALSE
5024,122,3,265,9,63,54,FALSE
5025,166,10,247,14,37,23,True
5026,100,3,76,17,35,18,FALSE
5027,133,16,205,13,31,18,FALSE
5028,111,16,125,9,100,91,FALSE
5029,199,12,215,9,82,73,FALSE
5030,88,10,264,18,40,22,FALSE
5031,139,13,149,8,71,63,FALSE
5032,77,13,31,17,82,65,FALSE
5033,171,10,68,1,88,87,FALSE
5034,123,29,83,16,90,74,FALSE
5035,174,17,124,9,54,45,FALSE
5036,161,9,282,14,99,85,FALSE
5037,180,7,174,2,25,23,FALSE
5038,186,5,240,10,27,17,FALSE
5039,129,13,150,9,62,53,FALSE
5040,96,29,68,19,36,17,FALSE
5041,27,10,300,11,40,29,FALSE
5042,34,19,66,5,74,69,FALSE
5043,33,10,228,8,80,72,FALSE
5044,165,4,287,8,50,42,True
5045,98,22,31,4,72,68,FALSE
5046,145,27,207,2,71,69,FALSE
5047,35,15,56,11,25,14,FALSE
5048,82,19,180,10,50,40,FALSE
5049,106,9,270,3,43,40,FALSE
5050,97,8,157,15,52,37,FALSE
5051,169,21,297,12,91,79,FALSE
5052,138,29,78,1,21,20,FALSE
5053,50,19,262,4,69,65,FALSE
5054,185,30,224,6,79,73,FALSE
5055,199,20,28,19,64,45,FALSE
5056,20,10,26,17,76,59,FALSE
5057,160,18,269,5,35,30,FALSE
5058,102,30,208,18,89,71,FALSE
5059,156,16,263,19,35,16,FALSE
5060,162,15,106,16,27,11,FALSE
5061,128,1,128,14,49,35,FALSE
5062,154,13,80,13,79,66,FALSE
5063,59,7,297,19,79,60,FALSE
5064,57,12,32,4,62,58,FALSE
5065,199,9,267,11,47,36,FALSE
5066,56,22,147,3,60,57,FALSE
5067,30,1,213,3,84,81,FALSE
5068,113,12,104,18,79,61,FALSE
5069,95,7,88,1,40,39,FALSE
5070,166,11,158,19,65,46,FALSE
5071,141,8,93,10,40,30,FALSE
5072,89,17,85,17,96,79,FALSE
5073,90,10,270,13,88,75,FALSE
5074,119,10,203,3,60,57,FALSE
5075,114,5,249,15,47,32,FALSE
5076,165,11,122,2,68,66,FALSE
5077,186,11,70,16,100,84,FALSE
5078,116,19,44,17,55,38,FALSE
5079,62,7,101,19,92,73,FALSE
5080,196,28,26,14,63,49,FALSE
5081,106,5,244,7,74,67,FALSE
5082,21,18,193,7,97,90,FALSE
5083,155,28,154,10,49,39,FALSE
5084,98,17,154,16,66,50,FALSE
5085,125,10,125,10,39,29,FALSE
5086,65,27,139,1,80,79,FALSE
5087,196,26,137,5,48,43,FALSE
5088,66,3,120,11,52,41,FALSE
5089,172,29,113,5,62,57,FALSE
5090,56,25,226,5,76,71,FALSE
5091,99,4,51,14,96,82,FALSE
5092,25,11,118,3,41,38,FALSE
5093,159,5,201,11,50,39,FALSE
5094,75,10,91,17,98,81,FALSE
5095,198,26,129,18,59,41,FALSE
5096,135,21,67,11,21,10,FALSE
5097,100,23,145,17,85,68,FALSE
5098,177,11,180,20,85,65,FALSE
5099,154,30,173,14,24,10,FALSE
5100,94,5,272,2,87,85,FALSE
5101,56,17,97,13,36,23,FALSE
5102,97,2,294,5,70,65,FALSE
5103,132,6,213,14,79,65,FALSE
5104,127,29,185,17,20,3,FALSE
5105,115,26,117,15,57,42,FALSE
5106,89,25,171,7,85,78,FALSE
5107,31,1,235,9,95,86,FALSE
5108,59,28,37,13,42,29,FALSE
5109,128,30,142,12,100,88,FALSE
5110,61,17,128,13,62,49,FALSE
5111,23,30,276,18,84,66,FALSE
5112,156,24,106,2,65,63,FALSE
5113,83,21,254,20,54,34,FALSE
5114,45,7,61,1,36,35,FALSE
5115,187,15,38,15,44,29,FALSE
5116,186,27,252,16,43,27,FALSE
5117,124,16,124,11,53,42,FALSE
5118,136,13,184,16,25,9,FALSE
5119,55,27,234,18,91,73,FALSE
5120,188,22,176,18,47,29,FALSE
5121,56,22,218,20,92,72,FALSE
5122,83,22,96,6,84,78,FALSE
5123,131,16,238,13,37,24,FALSE
5124,121,27,199,20,51,31,FALSE
5125,166,6,253,20,26,6,FALSE
5126,110,19,292,14,25,11,FALSE
5127,42,2,121,19,42,23,FALSE
5128,192,22,180,12,100,88,FALSE
5129,126,5,130,3,90,87,FALSE
5130,26,13,21,1,97,96,FALSE
5131,173,29,299,4,22,18,FALSE
5132,173,8,197,8,78,70,FALSE
5133,191,23,143,19,68,49,FALSE
5134,145,28,206,12,52,40,FALSE
5135,102,28,21,18,79,61,FALSE
5136,148,21,165,19,64,45,FALSE
5137,117,16,40,11,56,45,FALSE
5138,64,20,290,19,78,59,FALSE
5139,133,8,259,4,65,61,FALSE
5140,93,16,125,11,98,87,FALSE
5141,175,8,295,11,80,69,FALSE
5142,123,26,230,1,83,82,FALSE
5143,198,1,164,6,32,26,FALSE
5144,154,29,91,15,65,50,FALSE
5145,69,13,271,4,22,18,FALSE
5146,176,10,71,7,59,52,FALSE
5147,200,7,123,9,65,56,FALSE
5148,99,4,25,16,29,13,FALSE
5149,47,12,243,17,87,70,FALSE
5150,110,2,60,2,100,98,FALSE
5151,182,29,238,1,62,61,FALSE
5152,59,14,143,10,54,44,FALSE
5153,170,6,67,8,38,30,FALSE
5154,113,20,284,8,73,65,FALSE
5155,107,30,267,13,24,11,FALSE
5156,23,3,34,1,98,97,FALSE
5157,36,27,220,15,52,37,FALSE
5158,167,13,27,16,74,58,FALSE
5159,84,10,86,15,24,9,FALSE
5160,57,30,238,13,64,51,FALSE
5161,90,19,164,14,39,25,FALSE
5162,83,19,52,4,55,51,FALSE
5163,64,5,179,6,34,28,FALSE
5164,142,5,39,4,94,90,FALSE
5165,71,4,108,12,27,15,FALSE
5166,107,5,53,5,56,51,FALSE
5167,47,22,111,2,98,96,FALSE
5168,125,1,157,12,32,20,FALSE
5169,66,28,131,11,27,16,True
5170,164,16,298,14,76,62,True
5171,93,13,199,18,60,42,FALSE
5172,54,25,93,10,27,17,FALSE
5173,171,2,125,10,99,89,FALSE
5174,68,9,93,16,88,72,FALSE
5175,66,13,56,7,54,47,FALSE
5176,192,3,100,9,90,81,FALSE
5177,176,27,184,4,74,70,FALSE
5178,131,14,180,8,67,59,FALSE
5179,197,12,46,7,25,18,FALSE
5180,130,22,163,3,94,91,FALSE
5181,167,29,232,8,93,85,FALSE
5182,63,29,36,4,65,61,FALSE
5183,140,23,250,10,56,46,FALSE
5184,90,2,129,3,52,49,FALSE
5185,70,3,117,10,85,75,FALSE
5186,139,15,235,19,48,29,FALSE
5187,86,12,87,11,61,50,FALSE
5188,194,16,102,4,95,91,FALSE
5189,58,15,85,19,69,50,FALSE
5190,174,1,171,7,83,76,FALSE
5191,159,18,177,15,23,8,FALSE
5192,195,19,139,19,28,9,FALSE
5193,189,27,168,20,76,56,FALSE
5194,83,11,51,15,61,46,FALSE
5195,93,12,105,10,29,19,FALSE
5196,49,28,245,12,30,18,FALSE
5197,154,5,259,19,70,51,FALSE
5198,199,24,53,15,78,63,FALSE
5199,56,19,300,15,66,51,FALSE
5200,79,17,77,17,98,81,FALSE
5201,144,26,233,19,45,26,FALSE
5202,152,14,255,16,35,19,FALSE
5203,90,15,248,19,66,47,FALSE
5204,37,12,299,20,46,26,FALSE
5205,56,10,281,12,34,22,FALSE
5206,137,10,110,18,60,42,FALSE
5207,177,21,169,13,45,32,FALSE
5208,155,1,228,4,62,58,FALSE
5209,94,28,150,14,83,69,FALSE
5210,118,4,141,2,69,67,FALSE
5211,116,13,205,12,92,80,FALSE
5212,178,1,143,20,43,23,FALSE
5213,54,4,228,10,83,73,FALSE
5214,66,8,22,20,37,17,FALSE
5215,131,7,275,6,76,70,FALSE
5216,106,28,299,15,78,63,FALSE
5217,143,11,135,3,81,78,FALSE
5218,157,28,25,17,80,63,FALSE
5219,170,4,280,18,72,54,FALSE
5220,154,21,73,6,69,63,FALSE
5221,98,2,157,2,27,25,FALSE
5222,138,3,44,3,71,68,FALSE
5223,160,8,283,19,69,50,FALSE
5224,75,10,81,17,64,47,True
5225,74,3,296,13,45,32,FALSE
5226,101,23,83,9,81,72,FALSE
5227,76,8,289,16,61,45,FALSE
5228,43,21,41,8,62,54,True
5229,23,6,69,6,29,23,FALSE
5230,84,20,293,10,92,82,FALSE
5231,102,22,98,19,87,68,FALSE
5232,134,18,264,7,39,32,FALSE
5233,139,17,135,8,86,78,FALSE
5234,24,19,118,18,72,54,FALSE
5235,28,9,87,9,89,80,FALSE
5236,168,18,47,14,37,23,FALSE
5237,61,25,121,16,30,14,FALSE
5238,127,29,92,20,42,22,FALSE
5239,96,8,208,20,51,31,FALSE
5240,105,10,155,13,30,17,FALSE
5241,72,8,192,13,97,84,FALSE
5242,41,4,290,9,47,38,FALSE
5243,108,16,31,5,81,76,FALSE
5244,73,5,265,14,53,39,FALSE
5245,183,23,30,8,72,64,FALSE
5246,48,17,113,9,80,71,FALSE
5247,174,15,300,18,63,45,FALSE
5248,60,13,288,17,69,52,FALSE
5249,25,25,144,8,76,68,FALSE
5250,144,27,107,6,29,23,FALSE
5251,20,8,277,3,80,77,FALSE
5252,128,22,94,13,22,9,FALSE
5253,85,27,26,10,55,45,FALSE
5254,61,22,293,16,97,81,FALSE
5255,90,15,47,8,57,49,FALSE
5256,31,11,58,16,73,57,FALSE
5257,129,1,143,19,98,79,FALSE
5258,44,24,57,1,20,19,FALSE
5259,129,19,162,12,26,14,FALSE
5260,89,28,204,19,48,29,FALSE
5261,97,3,203,12,50,38,FALSE
5262,120,13,49,15,90,75,FALSE
5263,55,22,78,16,32,16,FALSE
5264,81,9,221,4,21,17,FALSE
5265,147,3,134,13,50,37,FALSE
5266,108,13,227,6,70,64,FALSE
5267,77,10,89,5,61,56,FALSE
5268,198,1,170,12,30,18,FALSE
5269,34,14,201,1,66,65,FALSE
5270,146,17,81,7,38,31,FALSE
5271,195,12,131,3,89,86,FALSE
5272,82,24,226,20,86,66,FALSE
5273,147,13,136,8,23,15,FALSE
5274,193,13,153,4,74,70,FALSE
5275,140,24,272,13,79,66,FALSE
5276,128,6,106,10,43,33,FALSE
5277,140,12,138,18,34,16,FALSE
5278,72,12,86,19,50,31,FALSE
5279,46,4,160,18,25,7,FALSE
5280,71,8,85,2,55,53,True
5281,143,18,25,14,72,58,FALSE
5282,89,6,286,10,95,85,FALSE
5283,55,21,29,13,90,77,FALSE
5284,22,10,168,6,50,44,FALSE
5285,174,17,101,12,83,71,FALSE
5286,89,2,227,14,54,40,FALSE
5287,151,22,90,7,23,16,FALSE
5288,86,28,276,17,84,67,FALSE
5289,87,21,258,13,26,13,FALSE
5290,99,18,191,2,52,50,FALSE
5291,23,7,269,16,95,79,FALSE
5292,91,9,288,11,80,69,FALSE
5293,144,21,82,4,36,32,FALSE
5294,107,27,264,15,66,51,FALSE
5295,96,27,230,7,44,37,FALSE
5296,70,21,242,3,32,29,FALSE
5297,59,9,248,10,46,36,True
5298,119,16,177,16,41,25,FALSE
5299,171,24,74,9,95,86,FALSE
5300,35,1,58,17,44,27,FALSE
5301,85,18,66,2,35,33,FALSE
5302,155,29,111,8,25,17,FALSE
5303,43,12,136,18,66,48,FALSE
5304,126,21,66,16,69,53,FALSE
5305,135,24,180,18,62,44,FALSE
5306,190,2,214,13,52,39,FALSE
5307,178,17,283,20,29,9,FALSE
5308,104,13,136,10,36,26,FALSE
5309,140,27,56,8,52,44,FALSE
5310,103,15,88,2,37,35,FALSE
5311,180,13,31,16,26,10,FALSE
5312,144,11,149,4,49,45,FALSE
5313,47,6,40,11,39,28,FALSE
5314,67,9,172,1,94,93,FALSE
5315,152,3,54,12,68,56,FALSE
5316,78,26,174,1,85,84,FALSE
5317,59,22,143,16,51,35,FALSE
5318,161,30,278,1,52,51,FALSE
5319,156,12,202,3,35,32,FALSE
5320,89,23,230,6,81,75,FALSE
5321,35,29,90,11,67,56,FALSE
5322,138,9,150,16,90,74,FALSE
5323,25,16,294,3,31,28,FALSE
5324,56,19,132,5,84,79,FALSE
5325,176,26,286,18,84,66,FALSE
5326,84,19,198,2,98,96,FALSE
5327,100,27,79,14,88,74,FALSE
5328,82,3,295,2,66,64,FALSE
5329,170,23,74,1,55,54,FALSE
5330,65,13,287,3,97,94,FALSE
5331,92,17,94,20,28,8,FALSE
5332,156,14,101,8,43,35,FALSE
5333,188,26,44,20,85,65,FALSE
5334,86,27,32,6,63,57,True
5335,107,26,157,8,47,39,FALSE
5336,170,20,88,11,94,83,FALSE
5337,26,28,137,6,27,21,FALSE
5338,113,20,103,15,32,17,FALSE
5339,60,25,167,15,76,61,FALSE
5340,36,30,28,18,52,34,FALSE
5341,51,12,24,20,72,52,FALSE
5342,193,20,273,17,93,76,FALSE
5343,65,11,162,10,31,21,True
5344,112,25,187,20,31,11,FALSE
5345,43,16,295,5,30,25,FALSE
5346,172,13,265,5,49,44,FALSE
5347,30,11,150,10,20,10,FALSE
5348,123,30,236,3,57,54,FALSE
5349,132,20,105,12,61,49,FALSE
5350,64,5,40,7,89,82,FALSE
5351,76,30,140,4,24,20,FALSE
5352,84,27,94,11,23,12,FALSE
5353,28,13,202,1,33,32,FALSE
5354,74,24,215,9,68,59,FALSE
5355,156,2,256,17,65,48,FALSE
5356,125,3,36,4,93,89,True
5357,135,10,257,6,54,48,FALSE
5358,81,20,49,8,47,39,FALSE
5359,145,9,263,1,95,94,FALSE
5360,166,23,97,17,71,54,FALSE
5361,37,1,114,5,94,89,FALSE
5362,123,7,48,6,43,37,FALSE
5363,145,1,164,14,42,28,FALSE
5364,60,24,264,11,69,58,FALSE
5365,191,30,294,18,87,69,FALSE
5366,194,17,253,4,94,90,FALSE
5367,51,13,273,17,55,38,FALSE
5368,151,12,247,17,51,34,FALSE
5369,76,4,142,14,65,51,FALSE
5370,79,22,222,13,77,64,FALSE
5371,137,4,172,9,32,23,FALSE
5372,190,23,137,6,24,18,FALSE
5373,94,19,26,1,86,85,FALSE
5374,159,15,221,16,61,45,FALSE
5375,144,9,102,4,94,90,True
5376,175,8,249,15,40,25,FALSE
5377,151,16,278,4,73,69,FALSE
5378,141,1,296,18,77,59,FALSE
5379,36,4,152,11,97,86,FALSE
5380,130,1,32,16,74,58,FALSE
5381,161,18,208,12,53,41,FALSE
5382,79,11,26,13,70,57,FALSE
5383,82,10,215,4,42,38,FALSE
5384,171,26,227,7,33,26,FALSE
5385,97,26,78,5,84,79,FALSE
5386,83,30,278,15,24,9,FALSE
5387,43,20,81,10,91,81,FALSE
5388,108,26,162,4,46,42,FALSE
5389,161,13,286,11,45,34,FALSE
5390,89,21,272,3,85,82,FALSE
5391,162,4,262,8,35,27,FALSE
5392,182,23,113,1,21,20,FALSE
5393,80,7,77,8,79,71,FALSE
5394,186,17,300,16,39,23,FALSE
5395,68,16,72,10,86,76,FALSE
5396,31,10,140,14,67,53,FALSE
5397,49,1,218,14,100,86,FALSE
5398,187,17,22,4,96,92,FALSE
5399,171,22,65,4,54,50,FALSE
5400,174,9,280,13,91,78,FALSE
5401,21,12,36,5,98,93,FALSE
5402,26,19,70,20,58,38,FALSE
5403,144,19,166,10,82,72,FALSE
5404,174,16,232,12,56,44,FALSE
5405,135,10,259,13,98,85,FALSE
5406,39,24,123,9,74,65,FALSE
5407,123,10,254,12,87,75,FALSE
5408,28,9,209,16,38,22,FALSE
5409,24,13,150,1,87,86,FALSE
5410,103,7,170,19,45,26,FALSE
5411,169,24,189,13,69,56,FALSE
5412,106,7,153,9,63,54,FALSE
5413,181,23,234,7,80,73,FALSE
5414,39,23,128,15,89,74,FALSE
5415,96,29,259,9,46,37,FALSE
5416,57,26,174,2,53,51,FALSE
5417,136,15,196,19,53,34,FALSE
5418,139,6,31,9,21,12,FALSE
5419,80,9,93,5,97,92,FALSE
5420,144,18,288,13,99,86,FALSE
5421,186,11,193,15,81,66,FALSE
5422,89,9,121,20,30,10,FALSE
5423,174,21,122,4,20,16,FALSE
5424,132,6,79,8,65,57,FALSE
5425,167,25,73,9,34,25,FALSE
5426,187,22,128,20,66,46,FALSE
5427,157,14,91,12,46,34,FALSE
5428,51,27,194,13,61,48,FALSE
5429,108,24,175,5,41,36,FALSE
5430,27,29,280,16,90,74,FALSE
5431,141,8,291,7,33,26,FALSE
5432,176,12,296,17,86,69,FALSE
5433,161,12,212,8,94,86,FALSE
5434,91,15,296,4,35,31,FALSE
5435,119,8,296,16,51,35,FALSE
5436,70,7,265,15,56,41,FALSE
5437,122,5,278,19,21,2,FALSE
5438,45,25,62,5,21,16,FALSE
5439,50,20,123,5,90,85,FALSE
5440,29,8,164,8,47,39,FALSE
5441,170,4,140,11,52,41,FALSE
5442,114,20,141,2,64,62,FALSE
5443,48,10,172,3,28,25,FALSE
5444,196,19,146,16,72,56,FALSE
5445,161,9,26,14,30,16,FALSE
5446,64,28,112,1,78,77,True
5447,111,3,74,15,41,26,FALSE
5448,104,15,275,14,78,64,FALSE
5449,183,21,255,3,95,92,FALSE
5450,154,20,64,16,98,82,FALSE
5451,93,25,167,1,51,50,FALSE
5452,146,21,193,7,67,60,FALSE
5453,106,11,55,11,64,53,FALSE
5454,117,16,206,18,78,60,FALSE
5455,35,17,285,11,100,89,FALSE
5456,174,13,142,5,69,64,FALSE
5457,45,18,177,1,71,70,FALSE
5458,105,11,29,6,66,60,FALSE
5459,84,17,81,11,23,12,FALSE
5460,197,15,273,19,22,3,FALSE
5461,164,17,191,18,29,11,FALSE
5462,53,23,111,15,82,67,FALSE
5463,176,2,133,11,29,18,FALSE
5464,170,15,22,19,74,55,FALSE
5465,129,24,297,9,37,28,FALSE
5466,134,18,41,2,100,98,True
5467,84,13,41,15,63,48,FALSE
5468,173,20,97,20,34,14,FALSE
5469,186,15,173,19,84,65,FALSE
5470,198,7,210,9,84,75,True
5471,165,13,291,5,74,69,FALSE
5472,59,10,48,16,48,32,FALSE
5473,146,27,294,2,52,50,FALSE
5474,88,23,204,16,25,9,FALSE
5475,20,30,196,12,75,63,FALSE
5476,118,22,292,13,30,17,FALSE
5477,86,16,44,6,98,92,FALSE
5478,78,21,184,20,52,32,FALSE
5479,183,14,221,5,68,63,FALSE
5480,57,17,252,4,89,85,FALSE
5481,28,6,268,12,61,49,FALSE
5482,141,23,231,5,78,73,FALSE
5483,56,11,79,5,43,38,FALSE
5484,197,10,114,3,96,93,FALSE
5485,193,16,146,20,71,51,FALSE
5486,192,24,48,1,95,94,FALSE
5487,122,2,86,7,74,67,FALSE
5488,138,28,92,2,53,51,FALSE
5489,181,30,77,20,74,54,FALSE
5490,193,28,68,17,95,78,FALSE
5491,118,7,68,17,57,40,True
5492,193,13,146,8,84,76,FALSE
5493,194,29,129,20,94,74,FALSE
5494,68,13,297,1,38,37,True
5495,57,6,135,14,89,75,FALSE
5496,189,26,99,4,88,84,FALSE
5497,60,30,141,9,77,68,FALSE
5498,21,23,250,15,69,54,True
5499,150,21,139,9,96,87,FALSE
5500,51,8,121,8,20,12,FALSE
5501,82,25,131,7,45,38,FALSE
5502,197,18,253,11,87,76,FALSE
5503,82,14,243,4,94,90,FALSE
5504,58,22,175,11,75,64,FALSE
5505,58,6,289,2,80,78,FALSE
5506,145,29,129,3,53,50,FALSE
5507,137,19,168,18,86,68,FALSE
5508,86,30,72,1,90,89,FALSE
5509,74,20,38,7,65,58,FALSE
5510,87,13,218,11,43,32,FALSE
5511,128,20,83,17,54,37,FALSE
5512,183,2,108,4,84,80,FALSE
5513,137,30,48,2,100,98,FALSE
5514,83,26,44,4,43,39,FALSE
5515,114,14,202,13,53,40,FALSE
5516,73,30,146,4,60,56,FALSE
5517,96,17,122,10,98,88,FALSE
5518,119,25,213,10,64,54,FALSE
5519,83,19,249,16,62,46,FALSE
5520,170,3,72,16,94,78,FALSE
5521,114,16,186,4,44,40,FALSE
5522,173,27,94,19,100,81,FALSE
5523,29,13,45,5,38,33,FALSE
5524,82,21,119,1,45,44,FALSE
5525,48,6,222,13,76,63,FALSE
5526,92,26,195,14,23,9,FALSE
5527,194,22,157,11,92,81,FALSE
5528,79,20,68,16,69,53,FALSE
5529,176,25,41,19,56,37,FALSE
5530,138,10,34,13,89,76,FALSE
5531,111,27,90,8,37,29,FALSE
5532,178,10,284,9,76,67,FALSE
5533,109,3,69,16,42,26,FALSE
5534,46,4,289,12,70,58,FALSE
5535,172,19,199,5,92,87,FALSE
5536,57,8,151,5,83,78,FALSE
5537,107,27,165,6,36,30,FALSE
5538,96,7,120,18,85,67,FALSE
5539,80,23,66,6,87,81,FALSE
5540,151,29,87,3,23,20,FALSE
5541,188,16,30,11,52,41,FALSE
5542,144,18,186,6,54,48,FALSE
5543,143,21,204,6,92,86,FALSE
5544,94,19,261,3,58,55,FALSE
5545,80,30,168,18,75,57,FALSE
5546,188,28,268,15,22,7,FALSE
5547,119,1,30,10,54,44,FALSE
5548,100,12,278,3,38,35,FALSE
5549,57,30,227,7,76,69,True
5550,47,2,295,11,72,61,FALSE
5551,154,27,125,7,29,22,FALSE
5552,162,10,234,12,75,63,FALSE
5553,112,23,20,4,65,61,FALSE
5554,100,27,290,13,28,15,FALSE
5555,38,17,129,7,37,30,FALSE
5556,40,9,36,8,30,22,FALSE
5557,97,13,262,3,25,22,FALSE
5558,80,15,22,19,58,39,FALSE
5559,23,22,204,12,73,61,FALSE
5560,67,2,80,13,59,46,FALSE
5561,53,22,188,13,100,87,FALSE
5562,146,2,122,19,57,38,FALSE
5563,176,12,224,20,80,60,FALSE
5564,179,10,292,20,93,73,FALSE
5565,93,20,178,8,89,81,FALSE
5566,193,21,114,3,81,78,FALSE
5567,114,6,209,10,50,40,FALSE
5568,80,1,115,6,75,69,FALSE
5569,190,21,282,3,62,59,FALSE
5570,57,4,147,9,35,26,FALSE
5571,41,15,271,9,65,56,FALSE
5572,128,7,101,11,92,81,True
5573,100,18,245,12,81,69,True
5574,184,12,86,19,42,23,FALSE
5575,49,20,204,7,87,80,FALSE
5576,152,2,59,20,71,51,FALSE
5577,83,23,175,4,47,43,FALSE
5578,124,3,91,14,98,84,FALSE
5579,110,1,142,18,62,44,FALSE
5580,43,4,218,12,70,58,FALSE
5581,192,13,52,20,61,41,FALSE
5582,180,7,57,19,61,42,True
5583,186,16,42,10,74,64,FALSE
5584,124,15,189,15,35,20,FALSE
5585,154,6,299,20,45,25,FALSE
5586,181,2,117,12,51,39,FALSE
5587,174,23,221,19,100,81,FALSE
5588,58,8,28,11,35,24,FALSE
5589,107,17,275,4,56,52,FALSE
5590,49,20,121,5,54,49,FALSE
5591,64,23,201,7,89,82,True
5592,109,14,153,14,81,67,FALSE
5593,111,1,184,14,25,11,FALSE
5594,121,13,206,6,95,89,FALSE
5595,117,18,192,12,96,84,FALSE
5596,196,15,177,12,88,76,FALSE
5597,39,4,138,4,76,72,FALSE
5598,81,24,258,3,68,65,FALSE
5599,190,19,157,16,74,58,FALSE
5600,95,18,81,19,91,72,FALSE
5601,84,20,226,20,96,76,FALSE
5602,28,23,180,7,65,58,FALSE
5603,194,2,282,14,53,39,FALSE
5604,116,29,258,11,78,67,FALSE
5605,77,11,269,6,67,61,FALSE
5606,74,27,231,10,73,63,FALSE
5607,190,23,138,8,73,65,FALSE
5608,26,5,300,2,21,19,FALSE
5609,99,10,256,13,49,36,FALSE
5610,90,19,257,13,58,45,FALSE
5611,112,24,21,8,33,25,FALSE
5612,50,7,124,5,29,24,FALSE
5613,165,8,168,6,49,43,FALSE
5614,161,2,91,13,21,8,FALSE
5615,145,21,89,7,78,71,FALSE
5616,64,17,204,2,41,39,FALSE
5617,51,15,57,1,42,41,FALSE
5618,110,1,136,20,69,49,FALSE
5619,49,9,28,5,51,46,FALSE
5620,30,20,217,1,58,57,FALSE
5621,152,3,129,11,63,52,FALSE
5622,61,6,300,13,33,20,FALSE
5623,44,17,129,4,95,91,FALSE
5624,186,27,51,12,39,27,True
5625,62,18,38,13,53,40,FALSE
5626,125,8,288,10,94,84,FALSE
5627,89,26,46,19,72,53,FALSE
5628,127,22,78,14,40,26,FALSE
5629,109,20,81,10,39,29,FALSE
5630,183,6,287,5,31,26,FALSE
5631,101,15,117,8,22,14,FALSE
5632,176,3,188,13,57,44,FALSE
5633,35,8,26,1,80,79,FALSE
5634,50,2,224,19,61,42,FALSE
5635,36,8,29,13,69,56,FALSE
5636,152,19,111,9,34,25,FALSE
5637,200,27,248,17,58,41,FALSE
5638,81,8,196,19,99,80,FALSE
5639,33,20,239,16,66,50,FALSE
5640,185,24,198,9,84,75,FALSE
5641,177,16,156,6,48,42,FALSE
5642,135,2,96,13,26,13,FALSE
5643,172,12,159,19,40,21,FALSE
5644,177,16,294,12,65,53,FALSE
5645,186,17,178,1,41,40,FALSE
5646,138,16,287,16,28,12,FALSE
5647,130,19,84,15,28,13,FALSE
5648,92,16,231,4,85,81,True
5649,147,5,293,4,48,44,FALSE
5650,61,18,243,17,52,35,FALSE
5651,115,12,261,20,51,31,FALSE
5652,63,24,208,14,93,79,FALSE
5653,130,8,70,17,98,81,FALSE
5654,79,12,78,15,27,12,FALSE
5655,143,25,216,19,93,74,FALSE
5656,101,20,90,5,48,43,FALSE
5657,130,18,106,8,92,84,FALSE
5658,172,13,127,14,74,60,FALSE
5659,47,12,275,8,87,79,FALSE
5660,176,19,106,11,69,58,FALSE
5661,97,12,227,13,33,20,FALSE
5662,101,17,264,8,36,28,FALSE
5663,178,16,221,9,36,27,FALSE
5664,186,26,182,17,55,38,FALSE
5665,131,15,45,11,46,35,FALSE
5666,58,20,139,9,25,16,FALSE
5667,125,14,135,19,75,56,FALSE
5668,98,25,257,15,78,63,FALSE
5669,162,16,180,3,28,25,FALSE
5670,111,5,87,18,72,54,FALSE
5671,71,26,169,8,95,87,FALSE
5672,181,11,49,2,37,35,FALSE
5673,168,13,140,20,84,64,FALSE
5674,63,16,243,15,73,58,FALSE
5675,68,10,296,16,48,32,FALSE
5676,153,10,73,11,31,20,FALSE
5677,59,2,210,20,63,43,FALSE
5678,60,27,70,10,65,55,FALSE
5679,69,11,174,10,36,26,FALSE
5680,24,16,123,10,87,77,FALSE
5681,82,8,91,15,32,17,FALSE
5682,108,6,230,14,73,59,FALSE
5683,77,4,272,17,41,24,FALSE
5684,116,25,47,12,57,45,FALSE
5685,42,18,187,18,46,28,FALSE
5686,45,1,133,12,88,76,FALSE
5687,113,12,87,3,51,48,FALSE
5688,50,15,32,2,54,52,FALSE
5689,132,20,253,8,91,83,FALSE
5690,66,25,171,14,81,67,FALSE
5691,118,19,223,18,66,48,FALSE
5692,181,30,271,20,63,43,FALSE
5693,40,11,20,17,38,21,FALSE
5694,149,10,36,11,84,73,FALSE
5695,104,12,29,1,45,44,FALSE
5696,36,5,94,12,48,36,FALSE
5697,80,5,94,13,39,26,FALSE
5698,133,11,85,16,78,62,FALSE
5699,61,16,279,9,40,31,FALSE
5700,109,16,102,5,56,51,FALSE
5701,33,3,136,20,81,61,FALSE
5702,81,19,194,20,91,71,FALSE
5703,145,19,21,5,93,88,FALSE
5704,55,4,21,12,63,51,FALSE
5705,185,2,51,8,26,18,FALSE
5706,101,19,81,5,81,76,FALSE
5707,151,10,261,4,44,40,FALSE
5708,89,15,204,17,50,33,FALSE
5709,81,21,235,11,29,18,FALSE
5710,110,20,105,15,23,8,FALSE
5711,178,27,107,1,51,50,FALSE
5712,122,5,202,14,71,57,FALSE
5713,129,12,135,8,88,80,FALSE
5714,51,8,127,5,45,40,FALSE
5715,66,23,238,19,97,78,FALSE
5716,38,20,140,13,66,53,FALSE
5717,134,17,247,19,46,27,FALSE
5718,183,28,155,13,73,60,FALSE
5719,70,18,225,4,90,86,FALSE
5720,146,17,28,6,35,29,FALSE
5721,66,6,223,10,88,78,FALSE
5722,186,25,299,15,27,12,FALSE
5723,107,23,222,16,34,18,FALSE
5724,77,10,198,16,64,48,FALSE
5725,148,10,157,12,39,27,FALSE
5726,86,2,265,13,86,73,FALSE
5727,34,2,226,2,95,93,FALSE
5728,173,5,140,14,30,16,FALSE
5729,114,24,20,5,79,74,FALSE
5730,76,18,208,11,78,67,FALSE
5731,131,14,158,6,100,94,FALSE
5732,67,13,202,19,25,6,FALSE
5733,153,5,253,11,36,25,FALSE
5734,158,2,150,18,66,48,FALSE
5735,176,26,279,7,55,48,FALSE
5736,159,9,147,5,37,32,FALSE
5737,38,11,128,20,78,58,FALSE
5738,174,5,40,15,37,22,FALSE
5739,65,22,41,16,23,7,FALSE
5740,141,20,196,16,60,44,FALSE
5741,185,4,298,12,41,29,FALSE
5742,89,30,140,12,50,38,True
5743,29,15,257,1,82,81,FALSE
5744,66,8,221,13,45,32,FALSE
5745,44,1,95,1,30,29,FALSE
5746,186,27,62,10,29,19,FALSE
5747,45,5,55,5,76,71,FALSE
5748,20,24,106,3,83,80,FALSE
5749,189,13,147,9,41,32,FALSE
5750,87,9,160,12,95,83,FALSE
5751,64,29,136,3,41,38,FALSE
5752,174,2,220,4,72,68,FALSE
5753,188,1,63,8,38,30,FALSE
5754,147,21,46,3,35,32,FALSE
5755,136,17,156,5,78,73,FALSE
5756,38,23,42,1,99,98,FALSE
5757,53,2,174,16,49,33,FALSE
5758,68,21,175,19,94,75,FALSE
5759,137,28,161,5,56,51,True
5760,124,9,134,5,37,32,FALSE
5761,140,6,87,18,47,29,FALSE
5762,115,16,104,1,77,76,FALSE
5763,108,20,240,14,94,80,FALSE
5764,142,24,167,3,32,29,FALSE
5765,164,16,250,2,78,76,FALSE
5766,138,11,130,2,66,64,FALSE
5767,23,13,151,5,49,44,FALSE
5768,113,29,107,1,41,40,FALSE
5769,147,13,213,16,90,74,FALSE
5770,119,8,28,11,25,14,FALSE
5771,41,22,195,11,71,60,FALSE
5772,50,22,254,12,100,88,FALSE
5773,26,20,253,12,54,42,FALSE
5774,117,3,293,8,28,20,FALSE
5775,189,8,185,12,34,22,FALSE
5776,144,23,64,4,59,55,FALSE
5777,131,1,26,8,70,62,FALSE
5778,138,1,178,2,100,98,FALSE
5779,167,14,267,4,94,90,FALSE
5780,181,26,237,13,68,55,FALSE
5781,118,15,163,15,81,66,FALSE
5782,196,29,169,16,27,11,FALSE
5783,61,3,229,11,75,64,FALSE
5784,115,24,137,5,23,18,FALSE
5785,57,2,68,19,64,45,FALSE
5786,32,13,20,12,69,57,FALSE
5787,67,11,50,12,70,58,FALSE
5788,124,5,66,14,35,21,FALSE
5789,99,26,55,17,69,52,FALSE
5790,188,12,134,12,74,62,FALSE
5791,170,1,251,17,72,55,FALSE
5792,162,23,89,19,91,72,FALSE
5793,192,27,21,7,89,82,FALSE
5794,30,22,43,15,56,41,FALSE
5795,82,2,58,14,90,76,FALSE
5796,133,5,297,2,75,73,FALSE
5797,91,4,128,5,58,53,FALSE
5798,130,20,152,10,33,23,FALSE
5799,123,18,193,3,87,84,FALSE
5800,172,14,197,2,20,18,FALSE
5801,156,28,143,16,22,6,FALSE
5802,138,30,182,15,72,57,FALSE
5803,69,5,100,18,71,53,FALSE
5804,164,17,186,8,56,48,FALSE
5805,22,11,134,16,50,34,FALSE
5806,118,9,156,13,36,23,FALSE
5807,106,30,88,4,46,42,FALSE
5808,137,23,254,8,41,33,FALSE
5809,187,12,155,16,48,32,FALSE
5810,85,13,71,17,47,30,FALSE
5811,89,5,251,12,47,35,FALSE
5812,27,28,211,1,73,72,FALSE
5813,63,19,145,7,75,68,FALSE
5814,66,5,249,6,72,66,FALSE
5815,141,23,122,6,59,53,FALSE
5816,168,10,123,19,35,16,FALSE
5817,154,20,226,5,85,80,FALSE
5818,55,23,21,8,85,77,FALSE
5819,46,12,176,3,76,73,FALSE
5820,152,13,286,16,100,84,FALSE
5821,142,12,206,3,72,69,FALSE
5822,77,13,91,5,99,94,FALSE
5823,199,11,223,12,67,55,FALSE
5824,119,7,54,2,93,91,FALSE
5825,25,13,86,20,61,41,FALSE
5826,127,4,299,3,94,91,True
5827,68,1,226,3,45,42,FALSE
5828,119,19,190,15,83,68,FALSE
5829,187,3,102,15,27,12,FALSE
5830,27,23,290,20,76,56,FALSE
5831,175,30,224,17,99,82,FALSE
5832,91,30,130,7,92,85,FALSE
5833,127,26,217,18,25,7,FALSE
5834,199,26,281,17,98,81,FALSE
5835,196,8,194,2,72,70,FALSE
5836,156,1,78,20,69,49,FALSE
5837,80,11,33,19,71,52,FALSE
5838,61,24,229,15,30,15,FALSE
5839,199,4,68,16,49,33,FALSE
5840,51,2,272,3,59,56,FALSE
5841,113,10,163,16,67,51,FALSE
5842,40,9,259,7,83,76,FALSE
5843,147,12,131,1,49,48,FALSE
5844,116,15,132,2,26,24,FALSE
5845,180,22,184,7,49,42,FALSE
5846,124,5,62,4,67,63,FALSE
5847,30,8,106,4,64,60,FALSE
5848,98,29,28,2,22,20,FALSE
5849,114,23,300,7,24,17,FALSE
5850,74,13,31,2,20,18,FALSE
5851,197,10,99,4,41,37,FALSE
5852,158,6,192,7,53,46,FALSE
5853,20,15,112,18,81,63,FALSE
5854,163,10,61,4,77,73,FALSE
5855,88,23,245,19,73,54,FALSE
5856,56,29,295,16,46,30,FALSE
5857,31,30,277,18,49,31,FALSE
5858,93,27,263,9,70,61,FALSE
5859,32,29,28,2,41,39,FALSE
5860,75,12,238,16,82,66,FALSE
5861,105,28,43,12,59,47,FALSE
5862,108,15,120,3,73,70,FALSE
5863,50,12,122,12,85,73,FALSE
5864,35,13,148,9,83,74,FALSE
5865,147,14,50,5,55,50,FALSE
5866,30,22,75,4,44,40,FALSE
5867,147,3,73,15,28,13,FALSE
5868,142,8,176,13,79,66,True
5869,190,17,54,20,29,9,FALSE
5870,77,11,36,4,33,29,FALSE
5871,20,8,30,18,64,46,FALSE
5872,181,19,38,15,38,23,FALSE
5873,30,15,237,5,91,86,FALSE
5874,81,29,71,6,27,21,FALSE
5875,38,5,228,17,78,61,FALSE
5876,158,15,226,18,34,16,FALSE
5877,107,27,226,20,24,4,FALSE
5878,26,24,166,18,94,76,FALSE
5879,117,6,145,11,85,74,FALSE
5880,76,11,218,12,52,40,FALSE
5881,72,14,258,19,40,21,FALSE
5882,59,24,160,10,62,52,FALSE
5883,174,1,45,7,73,66,FALSE
5884,177,19,221,3,65,62,FALSE
5885,73,17,145,16,34,18,FALSE
5886,94,12,105,12,72,60,FALSE
5887,121,20,164,4,100,96,FALSE
5888,76,28,146,3,72,69,FALSE
5889,194,12,128,17,22,5,FALSE
5890,62,1,161,19,31,12,FALSE
5891,123,17,143,7,70,63,FALSE
5892,68,6,96,14,50,36,FALSE
5893,112,7,107,6,95,89,FALSE
5894,48,21,190,7,84,77,FALSE
5895,195,2,131,7,50,43,FALSE
5896,84,12,237,20,42,22,FALSE
5897,160,16,21,7,74,67,FALSE
5898,65,4,249,10,30,20,FALSE
5899,83,19,37,19,49,30,FALSE
5900,34,2,298,2,29,27,FALSE
5901,144,14,40,8,100,92,FALSE
5902,73,15,259,20,87,67,FALSE
5903,75,18,218,8,38,30,FALSE
5904,127,20,64,19,60,41,FALSE
5905,82,18,219,6,48,42,FALSE
5906,89,27,94,15,51,36,FALSE
5907,79,12,24,8,48,40,FALSE
5908,51,17,55,17,39,22,FALSE
5909,101,11,42,10,73,63,FALSE
5910,136,10,298,17,62,45,True
5911,163,6,81,18,24,6,FALSE
5912,112,6,125,15,27,12,True
5913,67,3,216,10,54,44,FALSE
5914,70,15,96,11,40,29,FALSE
5915,27,20,89,15,89,74,True
5916,71,19,211,20,92,72,FALSE
5917,78,30,69,9,66,57,FALSE
5918,86,10,106,2,65,63,FALSE
5919,41,14,207,11,99,88,FALSE
5920,172,15,295,15,32,17,FALSE
5921,191,4,294,11,65,54,FALSE
5922,101,21,32,3,98,95,FALSE
5923,70,3,88,3,71,68,FALSE
5924,141,12,32,12,41,29,FALSE
5925,164,13,36,4,54,50,FALSE
5926,152,25,208,5,72,67,FALSE
5927,101,10,108,4,38,34,FALSE
5928,143,18,263,15,53,38,FALSE
5929,28,25,265,1,29,28,FALSE
5930,81,13,76,7,37,30,FALSE
5931,128,22,176,2,23,21,FALSE
5932,20,19,146,18,97,79,FALSE
5933,36,10,236,19,89,70,FALSE
5934,115,19,156,5,84,79,FALSE
5935,70,23,126,19,28,9,FALSE
5936,28,19,265,3,38,35,True
5937,100,2,228,6,43,37,FALSE
5938,65,26,210,11,61,50,FALSE
5939,167,21,280,10,60,50,FALSE
5940,59,18,38,15,81,66,FALSE
5941,52,8,102,8,74,66,FALSE
5942,162,19,256,14,40,26,FALSE
5943,52,5,179,1,98,97,FALSE
5944,85,3,240,15,31,16,True
5945,38,30,163,9,21,12,FALSE
5946,84,20,30,18,53,35,FALSE
5947,30,29,262,5,59,54,FALSE
5948,126,1,175,1,71,70,FALSE
5949,40,29,153,16,86,70,FALSE
5950,162,7,180,8,75,67,FALSE
5951,131,27,79,12,35,23,FALSE
5952,136,5,96,18,59,41,FALSE
5953,69,24,254,12,72,60,FALSE
5954,101,12,177,19,61,42,FALSE
5955,49,3,240,9,73,64,FALSE
5956,66,5,106,12,87,75,FALSE
5957,125,25,216,8,40,32,FALSE
5958,102,22,91,2,39,37,FALSE
5959,62,9,249,3,20,17,FALSE
5960,82,12,172,12,67,55,FALSE
5961,182,22,296,8,95,87,FALSE
5962,48,22,210,10,97,87,FALSE
5963,127,27,78,9,65,56,FALSE
5964,191,22,252,2,55,53,FALSE
5965,79,15,35,3,31,28,FALSE
5966,135,24,116,2,83,81,FALSE
5967,98,1,21,7,70,63,FALSE
5968,37,21,246,17,61,44,FALSE
5969,34,5,234,2,92,90,FALSE
5970,136,12,214,2,84,82,FALSE
5971,43,19,175,1,28,27,FALSE
5972,130,17,245,5,82,77,FALSE
5973,176,28,284,14,48,34,FALSE
5974,180,16,288,3,44,41,FALSE
5975,40,19,65,13,51,38,FALSE
5976,173,28,239,17,48,31,FALSE
5977,39,3,46,15,58,43,FALSE
5978,62,2,246,7,62,55,True
5979,186,22,153,18,97,79,FALSE
5980,62,14,294,17,59,42,FALSE
5981,118,13,98,15,24,9,FALSE
5982,147,23,25,10,47,37,FALSE
5983,155,21,91,17,56,39,FALSE
5984,42,14,271,6,64,58,FALSE
5985,72,26,27,17,22,5,FALSE
5986,79,22,273,18,58,40,FALSE
5987,165,2,267,1,32,31,True
5988,35,23,252,3,35,32,FALSE
5989,20,29,268,18,85,67,FALSE
5990,95,19,251,17,22,5,FALSE
5991,94,24,203,2,49,47,FALSE
5992,97,22,258,3,80,77,FALSE
5993,139,9,107,11,47,36,FALSE
5994,124,17,202,18,24,6,FALSE
5995,178,15,30,14,95,81,FALSE
5996,23,22,186,16,22,6,FALSE
5997,104,2,180,2,79,77,FALSE
5998,43,12,59,19,93,74,FALSE
5999,69,12,277,14,83,69,FALSE
6000,193,12,227,9,27,18,FALSE
6001,71,5,260,6,51,45,FALSE
6002,67,20,239,12,96,84,FALSE
6003,144,7,127,17,60,43,FALSE
6004,163,16,93,6,62,56,FALSE
6005,115,6,43,15,40,25,FALSE
6006,81,13,149,17,77,60,FALSE
6007,140,12,257,13,89,76,FALSE
6008,61,4,278,13,31,18,FALSE
6009,142,13,199,17,30,13,FALSE
6010,55,18,222,17,74,57,FALSE
6011,146,22,283,14,95,81,FALSE
6012,85,30,151,16,65,49,FALSE
6013,63,10,288,3,90,87,FALSE
6014,73,19,37,16,88,72,FALSE
6015,167,20,111,15,31,16,FALSE
6016,59,10,81,15,69,54,FALSE
6017,144,13,270,19,36,17,FALSE
6018,156,30,253,4,49,45,FALSE
6019,150,23,163,6,97,91,FALSE
6020,139,13,154,1,53,52,FALSE
6021,160,4,248,9,76,67,FALSE
6022,41,12,270,3,33,30,FALSE
6023,162,23,216,18,35,17,FALSE
6024,37,30,102,2,82,80,FALSE
6025,152,14,216,11,26,15,FALSE
6026,155,9,20,4,50,46,FALSE
6027,109,5,24,16,93,77,FALSE
6028,89,5,209,11,23,12,FALSE
6029,192,21,250,7,88,81,True
6030,63,9,164,12,38,26,FALSE
6031,79,12,223,16,26,10,FALSE
6032,169,16,68,2,26,24,FALSE
6033,71,2,95,6,40,34,FALSE
6034,73,6,111,7,37,30,FALSE
6035,156,23,191,3,33,30,FALSE
6036,141,3,84,5,45,40,FALSE
6037,77,8,69,17,92,75,FALSE
6038,147,8,192,14,45,31,FALSE
6039,110,12,120,20,54,34,FALSE
6040,194,16,101,5,61,56,FALSE
6041,24,27,156,10,47,37,FALSE
6042,175,10,45,12,21,9,True
6043,75,19,169,14,23,9,FALSE
6044,166,10,272,14,70,56,FALSE
6045,139,3,292,20,95,75,FALSE
6046,92,5,235,13,73,60,FALSE
6047,92,21,273,16,91,75,FALSE
6048,122,20,178,9,70,61,FALSE
6049,24,14,199,9,44,35,FALSE
6050,45,19,120,3,45,42,FALSE
6051,194,14,227,14,85,71,FALSE
6052,73,5,40,5,26,21,FALSE
6053,45,4,225,12,26,14,FALSE
6054,72,29,158,10,92,82,FALSE
6055,89,22,99,1,97,96,FALSE
6056,40,20,110,13,31,18,FALSE
6057,178,14,95,14,34,20,FALSE
6058,116,8,243,14,23,9,FALSE
6059,104,12,247,4,37,33,FALSE
6060,184,16,180,6,62,56,FALSE
6061,85,24,156,16,39,23,FALSE
6062,37,4,255,4,58,54,FALSE
6063,104,24,149,2,74,72,FALSE
6064,140,6,43,3,95,92,FALSE
6065,140,5,195,1,86,85,FALSE
6066,61,10,192,19,92,73,True
6067,137,20,219,13,98,85,FALSE
6068,131,21,244,17,76,59,FALSE
6069,35,12,75,14,75,61,FALSE
6070,46,14,284,2,80,78,FALSE
6071,190,26,95,2,74,72,FALSE
6072,163,8,189,1,55,54,FALSE
6073,42,16,74,2,84,82,FALSE
6074,67,6,216,5,60,55,FALSE
6075,114,10,110,19,84,65,FALSE
6076,101,5,87,19,59,40,FALSE
6077,107,13,263,19,75,56,FALSE
6078,69,13,112,6,85,79,FALSE
6079,79,14,70,18,47,29,FALSE
6080,199,30,185,1,89,88,FALSE
6081,111,4,73,11,46,35,FALSE
6082,29,7,117,17,32,15,FALSE
6083,199,15,270,4,22,18,FALSE
6084,147,28,133,3,23,20,True
6085,20,16,212,18,37,19,FALSE
6086,190,6,295,2,46,44,FALSE
6087,56,14,241,5,52,47,FALSE
6088,126,18,22,20,92,72,FALSE
6089,171,19,39,15,95,80,FALSE
6090,63,22,67,19,87,68,True
6091,94,19,241,1,34,33,FALSE
6092,35,5,224,7,41,34,FALSE
6093,85,26,20,9,66,57,FALSE
6094,30,26,105,19,28,9,FALSE
6095,110,21,299,14,99,85,FALSE
6096,78,11,295,6,76,70,FALSE
6097,155,7,139,7,28,21,FALSE
6098,177,17,36,13,95,82,FALSE
6099,60,22,81,9,60,51,FALSE
6100,138,19,32,14,86,72,FALSE
6101,49,13,23,10,35,25,FALSE
6102,38,17,192,19,86,67,FALSE
6103,92,22,81,13,98,85,FALSE
6104,54,28,176,2,43,41,FALSE
6105,189,19,244,8,35,27,FALSE
6106,60,17,113,15,92,77,FALSE
6107,71,16,236,10,80,70,True
6108,146,25,178,12,80,68,FALSE
6109,55,9,139,16,49,33,FALSE
6110,117,7,236,14,60,46,FALSE
6111,171,25,46,3,43,40,FALSE
6112,53,16,289,13,80,67,True
6113,197,18,100,17,62,45,FALSE
6114,173,14,128,5,77,72,FALSE
6115,152,9,293,6,69,63,FALSE
6116,176,1,177,3,53,50,FALSE
6117,90,22,168,9,46,37,FALSE
6118,141,27,25,10,52,42,FALSE
6119,58,6,148,7,55,48,FALSE
6120,197,2,36,9,81,72,FALSE
6121,46,5,22,17,31,14,FALSE
6122,123,15,162,8,84,76,True
6123,106,9,85,20,60,40,FALSE
6124,57,18,66,17,31,14,True
6125,198,4,123,20,20,0,FALSE
6126,82,18,87,7,66,59,FALSE
6127,195,26,201,11,43,32,FALSE
6128,166,12,65,12,59,47,FALSE
6129,64,20,228,8,81,73,FALSE
6130,128,12,214,17,93,76,FALSE
6131,125,20,241,20,77,57,FALSE
6132,198,30,290,17,24,7,FALSE
6133,98,24,26,15,67,52,FALSE
6134,60,20,49,4,30,26,FALSE
6135,199,5,118,16,24,8,FALSE
6136,191,5,131,13,82,69,FALSE
6137,172,16,120,1,24,23,FALSE
6138,183,19,184,3,20,17,FALSE
6139,60,15,191,10,22,12,FALSE
6140,79,5,104,15,79,64,FALSE
6141,198,4,55,16,47,31,FALSE
6142,108,23,266,14,24,10,FALSE
6143,26,3,185,10,22,12,FALSE
6144,135,16,86,4,22,18,FALSE
6145,65,22,255,10,27,17,FALSE
6146,125,14,267,20,50,30,FALSE
6147,193,8,123,16,54,38,FALSE
6148,42,29,157,7,87,80,FALSE
6149,38,21,68,15,74,59,True
6150,63,29,261,16,24,8,FALSE
6151,133,19,164,14,45,31,FALSE
6152,92,20,294,7,68,61,FALSE
6153,59,21,300,20,67,47,FALSE
6154,178,9,264,13,31,18,FALSE
6155,106,9,258,20,48,28,FALSE
6156,162,27,113,2,79,77,FALSE
6157,38,11,81,8,35,27,FALSE
6158,189,20,216,10,89,79,FALSE
6159,58,9,48,2,82,80,FALSE
6160,186,29,90,7,37,30,FALSE
6161,49,5,79,9,60,51,FALSE
6162,188,3,270,16,36,20,FALSE
6163,31,23,159,1,81,80,FALSE
6164,146,2,201,11,97,86,FALSE
6165,130,20,30,4,43,39,FALSE
6166,123,10,38,14,90,76,FALSE
6167,91,20,26,9,85,76,FALSE
6168,36,7,238,18,85,67,FALSE
6169,86,9,228,18,91,73,FALSE
6170,140,6,271,9,35,26,FALSE
6171,102,5,287,19,96,77,FALSE
6172,111,15,219,7,77,70,FALSE
6173,171,11,256,11,64,53,FALSE
6174,117,3,135,20,25,5,FALSE
6175,124,30,57,3,96,93,FALSE
6176,180,21,33,2,22,20,FALSE
6177,120,13,163,11,26,15,FALSE
6178,50,17,138,5,91,86,FALSE
6179,179,12,227,9,79,70,FALSE
6180,121,4,243,11,99,88,FALSE
6181,141,20,49,7,90,83,FALSE
6182,85,28,254,19,80,61,FALSE
6183,91,21,147,11,24,13,FALSE
6184,34,26,184,15,25,10,FALSE
6185,142,11,124,17,84,67,FALSE
6186,121,3,203,4,46,42,FALSE
6187,80,18,159,7,74,67,FALSE
6188,59,19,89,13,26,13,FALSE
6189,47,4,58,11,47,36,FALSE
6190,136,29,95,18,40,22,FALSE
6191,147,4,179,18,78,60,FALSE
6192,24,7,292,4,66,62,FALSE
6193,186,12,89,15,64,49,FALSE
6194,72,4,119,1,58,57,FALSE
6195,102,1,132,9,35,26,FALSE
6196,157,23,226,13,43,30,FALSE
6197,168,12,131,16,22,6,FALSE
6198,26,24,150,17,92,75,FALSE
6199,22,29,238,16,41,25,FALSE
6200,22,3,257,2,100,98,FALSE
6201,45,28,206,3,58,55,FALSE
6202,52,24,256,9,29,20,FALSE
6203,131,9,204,3,98,95,FALSE
6204,34,7,204,2,42,40,True
6205,182,7,232,9,46,37,True
6206,23,7,176,9,82,73,FALSE
6207,134,6,160,19,48,29,FALSE
6208,186,29,155,18,49,31,FALSE
6209,83,26,183,11,69,58,FALSE
6210,161,29,126,1,54,53,FALSE
6211,199,19,83,2,98,96,FALSE
6212,123,6,250,14,50,36,FALSE
6213,110,8,55,15,61,46,FALSE
6214,160,23,60,4,30,26,FALSE
6215,193,3,204,14,24,10,FALSE
6216,49,11,214,18,60,42,FALSE
6217,193,24,174,9,21,12,FALSE
6218,176,23,163,11,55,44,FALSE
6219,148,7,72,3,82,79,FALSE
6220,146,19,262,1,85,84,FALSE
6221,47,29,82,9,72,63,FALSE
6222,116,13,61,2,51,49,FALSE
6223,128,16,58,16,21,5,FALSE
6224,50,7,71,16,41,25,FALSE
6225,159,1,166,17,59,42,FALSE
6226,22,16,114,2,41,39,FALSE
6227,105,5,111,7,44,37,FALSE
6228,60,14,44,15,62,47,FALSE
6229,86,6,124,4,97,93,FALSE
6230,25,8,293,1,32,31,FALSE
6231,79,18,172,7,97,90,FALSE
6232,175,15,182,14,20,6,FALSE
6233,36,21,293,16,67,51,FALSE
6234,150,29,216,19,78,59,FALSE
6235,44,6,281,17,94,77,FALSE
6236,46,7,185,11,31,20,FALSE
6237,39,17,185,14,52,38,FALSE
6238,41,11,195,6,82,76,FALSE
6239,30,1,239,17,68,51,FALSE
6240,183,17,226,15,76,61,FALSE
6241,82,9,34,11,41,30,FALSE
6242,111,29,234,10,93,83,FALSE
6243,48,26,260,20,74,54,FALSE
6244,158,10,279,20,45,25,FALSE
6245,78,25,122,5,98,93,FALSE
6246,119,25,257,4,22,18,FALSE
6247,65,17,79,11,24,13,FALSE
6248,147,4,45,5,32,27,FALSE
6249,39,29,282,13,58,45,FALSE
6250,161,2,167,7,88,81,FALSE
6251,190,13,104,20,29,9,FALSE
6252,93,9,214,13,55,42,FALSE
6253,185,7,276,11,95,84,FALSE
6254,110,29,158,1,59,58,FALSE
6255,120,5,149,3,88,85,FALSE
6256,86,14,63,7,58,51,FALSE
6257,100,3,212,4,47,43,FALSE
6258,136,20,59,12,99,87,FALSE
6259,108,7,279,13,80,67,FALSE
6260,154,5,222,19,53,34,FALSE
6261,167,3,235,8,33,25,FALSE
6262,95,18,192,2,35,33,FALSE
6263,119,13,44,13,48,35,FALSE
6264,48,16,127,3,59,56,FALSE
6265,187,18,70,13,81,68,FALSE
6266,166,18,79,15,59,44,True
6267,163,12,81,12,53,41,FALSE
6268,166,27,242,16,23,7,FALSE
6269,25,10,23,18,33,15,FALSE
6270,51,3,298,8,86,78,FALSE
6271,172,13,203,18,56,38,FALSE
6272,40,9,28,6,93,87,FALSE
6273,158,26,290,17,82,65,FALSE
6274,62,6,116,12,65,53,FALSE
6275,197,2,86,7,88,81,FALSE
6276,23,2,40,1,37,36,FALSE
6277,174,27,170,4,58,54,FALSE
6278,135,7,58,15,75,60,FALSE
6279,196,25,299,7,41,34,FALSE
6280,188,9,234,10,65,55,FALSE
6281,183,15,46,4,86,82,FALSE
6282,72,21,193,18,23,5,FALSE
6283,55,30,49,13,50,37,FALSE
6284,182,7,206,9,97,88,FALSE
6285,120,22,32,4,64,60,FALSE
6286,53,13,290,9,96,87,FALSE
6287,168,24,198,6,72,66,FALSE
6288,60,26,46,16,69,53,FALSE
6289,25,12,114,10,83,73,FALSE
6290,106,5,253,14,28,14,FALSE
6291,108,11,295,18,57,39,FALSE
6292,73,19,297,12,91,79,FALSE
6293,70,4,250,11,50,39,FALSE
6294,147,5,197,17,21,4,FALSE
6295,106,16,224,4,82,78,FALSE
6296,151,8,280,7,23,16,FALSE
6297,166,12,90,5,57,52,FALSE
6298,22,1,203,16,97,81,FALSE
6299,106,21,102,20,64,44,FALSE
6300,66,4,268,15,95,80,FALSE
6301,22,27,122,8,36,28,FALSE
6302,47,12,108,17,27,10,FALSE
6303,164,3,278,10,71,61,FALSE
6304,49,2,230,12,57,45,FALSE
6305,173,25,27,15,97,82,FALSE
6306,171,11,297,3,76,73,FALSE
6307,93,14,150,1,50,49,FALSE
6308,179,3,195,13,26,13,True
6309,155,2,141,12,57,45,FALSE
6310,148,4,260,11,33,22,FALSE
6311,32,12,21,10,84,74,FALSE
6312,160,19,114,2,37,35,FALSE
6313,47,30,63,13,94,81,FALSE
6314,169,21,83,17,81,64,FALSE
6315,175,2,154,6,84,78,FALSE
6316,165,22,96,16,71,55,FALSE
6317,59,4,71,14,62,48,FALSE
6318,33,3,178,9,23,14,FALSE
6319,114,30,116,10,54,44,FALSE
6320,148,29,279,16,46,30,FALSE
6321,42,12,91,3,83,80,True
6322,74,5,83,8,65,57,FALSE
6323,77,21,289,12,80,68,FALSE
6324,45,2,28,14,36,22,FALSE
6325,196,23,113,5,91,86,FALSE
6326,105,29,200,4,37,33,FALSE
6327,138,15,102,7,42,35,FALSE
6328,162,24,86,19,63,44,FALSE
6329,83,16,200,4,55,51,FALSE
6330,29,25,49,12,53,41,FALSE
6331,66,15,197,15,88,73,FALSE
6332,26,21,179,12,54,42,FALSE
6333,113,27,179,18,25,7,FALSE
6334,91,11,291,10,62,52,FALSE
6335,114,30,89,13,77,64,FALSE
6336,96,16,262,19,97,78,FALSE
6337,138,26,148,19,90,71,FALSE
6338,118,29,95,19,85,66,FALSE
6339,118,12,109,17,87,70,FALSE
6340,48,17,136,4,42,38,FALSE
6341,152,3,215,18,33,15,FALSE
6342,51,21,87,6,31,25,FALSE
6343,111,6,289,8,46,38,True
6344,131,1,249,19,62,43,FALSE
6345,74,25,152,6,85,79,FALSE
6346,200,9,85,8,50,42,FALSE
6347,62,30,272,20,79,59,FALSE
6348,152,1,279,13,31,18,FALSE
6349,35,1,69,3,95,92,FALSE
6350,175,28,222,5,23,18,FALSE
6351,66,8,92,16,26,10,FALSE
6352,68,6,106,9,72,63,FALSE
6353,64,7,263,3,50,47,FALSE
6354,102,25,56,12,57,45,FALSE
6355,44,18,246,6,74,68,True
6356,34,25,144,18,46,28,FALSE
6357,24,17,28,13,85,72,FALSE
6358,28,1,25,6,41,35,FALSE
6359,150,17,114,16,28,12,FALSE
6360,87,11,29,10,76,66,FALSE
6361,162,17,184,13,46,33,FALSE
6362,47,8,26,14,98,84,FALSE
6363,136,11,25,5,56,51,FALSE
6364,130,28,193,12,64,52,FALSE
6365,150,4,117,17,43,26,FALSE
6366,131,14,231,7,60,53,FALSE
6367,120,3,80,16,34,18,FALSE
6368,153,8,176,17,21,4,FALSE
6369,30,23,40,8,40,32,FALSE
6370,131,13,114,3,87,84,FALSE
6371,160,29,210,13,55,42,FALSE
6372,155,10,30,19,61,42,FALSE
6373,34,2,248,17,53,36,True
6374,115,1,289,18,84,66,FALSE
6375,68,16,48,9,98,89,FALSE
6376,72,13,173,4,94,90,FALSE
6377,65,4,171,3,94,91,FALSE
6378,114,19,49,5,60,55,FALSE
6379,96,15,213,1,58,57,FALSE
6380,99,8,182,7,85,78,FALSE
6381,125,24,292,19,64,45,True
6382,36,23,187,15,52,37,FALSE
6383,179,14,210,7,43,36,FALSE
6384,44,16,283,15,65,50,FALSE
6385,102,26,293,15,74,59,FALSE
6386,39,30,248,17,20,3,FALSE
6387,45,8,300,3,76,73,FALSE
6388,187,17,79,10,66,56,FALSE
6389,111,4,80,10,60,50,FALSE
6390,104,2,169,1,29,28,True
6391,30,14,180,2,27,25,FALSE
6392,192,24,112,1,83,82,FALSE
6393,102,23,194,2,62,60,FALSE
6394,130,19,22,13,78,65,FALSE
6395,41,23,142,6,64,58,FALSE
6396,42,19,58,13,70,57,FALSE
6397,99,29,203,12,71,59,FALSE
6398,48,30,257,10,77,67,FALSE
6399,174,5,180,11,87,76,FALSE
6400,87,1,63,8,52,44,FALSE
6401,26,12,203,9,37,28,FALSE
6402,65,16,23,18,84,66,FALSE
6403,42,7,75,20,49,29,FALSE
6404,165,26,138,20,33,13,FALSE
6405,65,3,121,19,82,63,FALSE
6406,178,10,119,9,27,18,FALSE
6407,129,15,105,4,59,55,FALSE
6408,86,25,136,8,46,38,FALSE
6409,103,1,60,10,71,61,FALSE
6410,110,30,115,4,91,87,FALSE
6411,111,1,158,3,44,41,FALSE
6412,63,9,189,1,42,41,FALSE
6413,183,9,215,4,83,79,FALSE
6414,25,1,210,8,48,40,FALSE
6415,131,4,141,20,49,29,FALSE
6416,183,16,35,16,76,60,FALSE
6417,67,25,221,20,39,19,FALSE
6418,156,6,226,20,76,56,FALSE
6419,122,6,260,6,66,60,FALSE
6420,59,12,277,1,59,58,FALSE
6421,155,8,198,12,41,29,FALSE
6422,134,8,84,15,27,12,FALSE
6423,141,7,191,13,60,47,FALSE
6424,79,10,95,17,83,66,FALSE
6425,112,27,131,12,43,31,FALSE
6426,139,8,265,20,45,25,FALSE
6427,192,5,59,4,29,25,FALSE
6428,109,28,34,20,61,41,FALSE
6429,51,19,121,11,72,61,FALSE
6430,105,23,298,14,49,35,FALSE
6431,104,4,234,17,47,30,FALSE
6432,58,4,94,18,47,29,FALSE
6433,51,24,165,7,30,23,FALSE
6434,148,26,62,11,61,50,FALSE
6435,169,19,88,19,37,18,FALSE
6436,25,28,200,4,81,77,FALSE
6437,170,5,171,15,84,69,FALSE
6438,160,18,291,9,34,25,FALSE
6439,119,10,131,14,74,60,FALSE
6440,140,20,113,2,85,83,FALSE
6441,66,30,242,12,98,86,FALSE
6442,168,5,56,20,60,40,FALSE
6443,188,18,30,7,87,80,FALSE
6444,146,3,277,13,39,26,FALSE
6445,151,5,290,13,83,70,FALSE
6446,157,12,185,7,72,65,FALSE
6447,80,19,25,20,60,40,FALSE
6448,86,9,85,18,44,26,FALSE
6449,159,22,251,1,67,66,FALSE
6450,25,25,171,9,79,70,FALSE
6451,177,17,42,4,56,52,FALSE
6452,64,19,59,13,20,7,FALSE
6453,181,14,191,6,47,41,FALSE
6454,157,15,182,3,93,90,FALSE
6455,75,9,272,10,26,16,FALSE
6456,158,15,77,12,67,55,FALSE
6457,174,11,212,16,29,13,FALSE
6458,119,13,275,17,74,57,FALSE
6459,57,8,36,17,83,66,FALSE
6460,139,1,258,3,24,21,FALSE
6461,115,5,81,12,54,42,FALSE
6462,179,1,291,8,62,54,FALSE
6463,108,13,215,10,25,15,FALSE
6464,58,10,69,16,34,18,FALSE
6465,101,17,132,10,88,78,FALSE
6466,155,24,85,8,79,71,FALSE
6467,55,11,35,2,83,81,FALSE
6468,79,29,293,11,77,66,FALSE
6469,151,28,270,17,76,59,FALSE
6470,70,7,100,11,35,24,True
6471,140,8,229,10,21,11,FALSE
6472,200,10,285,7,59,52,FALSE
6473,96,20,119,10,65,55,FALSE
6474,186,5,94,4,97,93,FALSE
6475,57,16,47,8,64,56,FALSE
6476,117,30,114,12,68,56,FALSE
6477,58,2,145,16,86,70,FALSE
6478,125,1,68,18,70,52,FALSE
6479,43,30,23,1,46,45,FALSE
6480,123,2,132,2,60,58,FALSE
6481,35,18,32,20,20,0,FALSE
6482,152,24,96,4,79,75,FALSE
6483,63,30,178,8,39,31,FALSE
6484,62,13,67,5,83,78,FALSE
6485,146,18,139,13,27,14,FALSE
6486,32,22,260,8,23,15,FALSE
6487,173,29,281,20,43,23,FALSE
6488,89,10,36,8,66,58,FALSE
6489,86,16,211,13,51,38,FALSE
6490,178,19,146,5,97,92,FALSE
6491,28,18,128,7,27,20,FALSE
6492,48,14,185,4,82,78,FALSE
6493,161,8,27,17,70,53,FALSE
6494,124,21,94,8,86,78,FALSE
6495,61,24,232,14,40,26,FALSE
6496,38,28,167,13,35,22,FALSE
6497,62,17,166,14,28,14,FALSE
6498,67,16,90,8,54,46,FALSE
6499,148,16,74,18,23,5,FALSE
6500,135,12,74,6,49,43,FALSE
6501,121,12,115,15,29,14,FALSE
6502,65,2,239,6,31,25,FALSE
6503,29,18,45,7,71,64,FALSE
6504,55,3,187,11,77,66,True
6505,28,22,296,5,96,91,FALSE
6506,148,6,109,10,24,14,FALSE
6507,161,23,233,11,72,61,FALSE
6508,163,25,81,12,79,67,FALSE
6509,64,9,213,3,100,97,FALSE
6510,134,20,250,2,54,52,FALSE
6511,49,10,212,12,60,48,FALSE
6512,49,19,53,17,81,64,True
6513,187,27,277,13,66,53,FALSE
6514,32,28,267,13,70,57,FALSE
6515,74,14,144,10,45,35,FALSE
6516,175,28,279,5,95,90,FALSE
6517,124,24,286,2,58,56,FALSE
6518,146,16,239,18,47,29,FALSE
6519,188,30,219,3,94,91,FALSE
6520,164,25,274,12,55,43,FALSE
6521,83,9,171,3,32,29,FALSE
6522,54,6,207,7,92,85,FALSE
6523,67,9,149,13,94,81,FALSE
6524,180,5,61,1,84,83,FALSE
6525,163,18,45,10,79,69,FALSE
6526,173,23,36,7,47,40,FALSE
6527,144,4,45,1,43,42,FALSE
6528,80,25,74,11,76,65,FALSE
6529,125,25,288,18,35,17,FALSE
6530,53,14,238,18,45,27,FALSE
6531,88,2,74,5,54,49,FALSE
6532,27,11,65,5,41,36,FALSE
6533,85,4,138,2,38,36,FALSE
6534,185,20,61,4,30,26,FALSE
6535,130,24,196,10,52,42,FALSE
6536,88,5,171,17,60,43,FALSE
6537,126,8,98,6,20,14,FALSE
6538,171,20,37,20,81,61,FALSE
6539,61,4,269,3,27,24,FALSE
6540,64,12,111,15,28,13,FALSE
6541,185,23,71,14,25,11,FALSE
6542,154,15,29,12,68,56,FALSE
6543,144,12,282,9,83,74,FALSE
6544,191,14,54,19,69,50,FALSE
6545,121,5,218,4,62,58,FALSE
6546,62,8,279,2,91,89,FALSE
6547,34,22,130,2,44,42,FALSE
6548,193,13,60,11,83,72,FALSE
6549,186,20,162,11,78,67,FALSE
6550,185,2,134,15,87,72,FALSE
6551,169,16,148,13,84,71,FALSE
6552,200,20,245,7,34,27,FALSE
6553,67,28,63,10,46,36,FALSE
6554,172,30,188,4,33,29,FALSE
6555,28,4,262,15,31,16,FALSE
6556,52,17,216,5,28,23,FALSE
6557,32,10,275,5,66,61,FALSE
6558,128,30,132,6,81,75,FALSE
6559,61,21,54,12,47,35,FALSE
6560,69,7,147,14,56,42,FALSE
6561,157,19,84,19,92,73,FALSE
6562,135,22,120,7,77,70,FALSE
6563,78,4,162,5,45,40,FALSE
6564,42,19,190,8,70,62,FALSE
6565,110,10,243,9,26,17,FALSE
6566,141,25,253,3,93,90,FALSE
6567,115,3,115,5,49,44,FALSE
6568,100,28,138,6,34,28,FALSE
6569,59,3,213,5,79,74,FALSE
6570,41,20,57,7,38,31,FALSE
6571,136,5,264,3,95,92,FALSE
6572,37,9,286,16,23,7,FALSE
6573,67,2,209,19,71,52,FALSE
6574,123,19,94,16,83,67,FALSE
6575,93,12,132,5,38,33,FALSE
6576,150,20,44,19,71,52,FALSE
6577,186,24,202,1,81,80,FALSE
6578,47,2,179,6,95,89,FALSE
6579,66,14,72,11,41,30,FALSE
6580,113,6,251,9,31,22,FALSE
6581,132,19,29,4,47,43,FALSE
6582,114,4,93,13,89,76,FALSE
6583,126,4,178,16,89,73,FALSE
6584,107,5,271,17,53,36,FALSE
6585,135,7,75,3,99,96,FALSE
6586,27,18,149,5,41,36,FALSE
6587,31,25,242,12,70,58,FALSE
6588,34,25,157,17,97,80,FALSE
6589,52,24,54,9,29,20,FALSE
6590,34,28,203,4,79,75,FALSE
6591,113,21,109,7,37,30,FALSE
6592,141,9,127,4,35,31,FALSE
6593,196,28,64,16,74,58,FALSE
6594,83,5,45,10,66,56,FALSE
6595,135,20,210,7,85,78,FALSE
6596,125,22,77,5,32,27,FALSE
6597,175,22,21,12,33,21,FALSE
6598,48,8,240,18,57,39,FALSE
6599,28,11,182,11,55,44,FALSE
6600,175,19,293,14,44,30,FALSE
6601,92,16,71,14,39,25,True
6602,66,21,288,7,38,31,FALSE
6603,74,28,194,20,90,70,FALSE
6604,179,24,95,13,92,79,True
6605,67,23,226,20,63,43,FALSE
6606,194,14,296,10,89,79,FALSE
6607,20,2,265,19,72,53,FALSE
6608,83,14,202,8,79,71,FALSE
6609,23,2,138,6,71,65,FALSE
6610,110,14,249,20,87,67,FALSE
6611,130,14,157,8,25,17,FALSE
6612,184,30,269,4,69,65,FALSE
6613,182,25,143,2,41,39,FALSE
6614,122,20,222,8,49,41,FALSE
6615,93,10,246,19,55,36,FALSE
6616,143,14,233,10,96,86,FALSE
6617,77,24,134,10,22,12,FALSE
6618,61,10,67,1,52,51,FALSE
6619,146,18,210,2,48,46,FALSE
6620,182,20,245,14,66,52,FALSE
6621,78,15,214,20,58,38,FALSE
6622,183,27,80,6,70,64,FALSE
6623,150,25,78,17,54,37,FALSE
6624,80,7,164,6,65,59,FALSE
6625,99,4,287,12,25,13,FALSE
6626,74,9,159,3,85,82,FALSE
6627,104,13,234,10,76,66,FALSE
6628,36,14,264,8,21,13,FALSE
6629,66,30,155,20,41,21,FALSE
6630,121,20,152,18,26,8,True
6631,105,27,272,2,40,38,FALSE
6632,136,6,300,8,87,79,FALSE
6633,150,11,62,8,96,88,FALSE
6634,169,15,271,8,82,74,FALSE
6635,127,6,246,15,26,11,FALSE
6636,131,5,300,8,40,32,FALSE
6637,33,5,183,10,57,47,FALSE
6638,129,23,300,1,29,28,True
6639,199,3,287,14,48,34,FALSE
6640,35,27,219,15,63,48,FALSE
6641,125,11,261,20,24,4,FALSE
6642,25,30,296,7,39,32,FALSE
6643,157,3,278,11,22,11,FALSE
6644,86,7,59,10,38,28,FALSE
6645,80,26,84,17,50,33,FALSE
6646,67,6,206,20,59,39,FALSE
6647,65,4,243,1,87,86,FALSE
6648,117,30,293,8,61,53,FALSE
6649,185,19,55,17,22,5,FALSE
6650,139,3,65,19,86,67,FALSE
6651,131,27,33,5,98,93,FALSE
6652,198,1,87,17,28,11,FALSE
6653,61,15,121,5,32,27,FALSE
6654,69,22,149,2,45,43,FALSE
6655,193,8,206,20,64,44,True
6656,39,18,226,11,32,21,FALSE
6657,132,24,178,17,51,34,True
6658,131,21,196,5,87,82,FALSE
6659,91,26,24,18,83,65,FALSE
6660,88,15,115,6,28,22,FALSE
6661,42,6,242,16,61,45,FALSE
6662,50,30,63,11,62,51,FALSE
6663,93,26,63,6,53,47,FALSE
6664,138,9,180,10,67,57,FALSE
6665,198,30,183,15,26,11,FALSE
6666,105,5,219,19,97,78,FALSE
6667,48,28,113,10,43,33,FALSE
6668,67,2,88,5,72,67,FALSE
6669,114,4,61,16,92,76,FALSE
6670,173,16,32,14,87,73,FALSE
6671,156,15,274,10,28,18,FALSE
6672,47,18,283,4,37,33,FALSE
6673,191,24,281,20,80,60,FALSE
6674,28,21,142,20,63,43,FALSE
6675,42,1,117,3,82,79,FALSE
6676,149,11,144,12,51,39,FALSE
6677,55,1,135,7,34,27,FALSE
6678,52,28,118,14,59,45,FALSE
6679,154,27,213,12,99,87,FALSE
6680,100,7,294,5,91,86,FALSE
6681,110,1,42,2,49,47,FALSE
6682,62,28,136,8,41,33,FALSE
6683,116,18,196,13,49,36,FALSE
6684,165,9,73,3,88,85,FALSE
6685,66,20,110,5,70,65,FALSE
6686,108,7,283,1,54,53,FALSE
6687,195,27,134,9,88,79,FALSE
6688,28,20,146,13,94,81,FALSE
6689,158,29,103,10,74,64,FALSE
6690,152,20,133,10,51,41,FALSE
6691,199,19,244,14,42,28,FALSE
6692,131,11,288,20,66,46,FALSE
6693,97,22,60,11,82,71,FALSE
6694,53,28,126,7,62,55,FALSE
6695,70,22,246,2,84,82,FALSE
6696,36,20,166,8,88,80,FALSE
6697,115,3,147,6,58,52,FALSE
6698,87,22,70,3,25,22,FALSE
6699,75,27,47,18,26,8,FALSE
6700,83,14,193,15,39,24,FALSE
6701,170,3,129,5,37,32,FALSE
6702,177,11,186,12,24,12,FALSE
6703,182,19,260,4,50,46,FALSE
6704,121,1,177,19,52,33,FALSE
6705,58,28,292,18,84,66,FALSE
6706,59,9,179,14,46,32,FALSE
6707,49,8,141,5,47,42,FALSE
6708,87,8,59,2,96,94,FALSE
6709,193,23,185,20,79,59,FALSE
6710,141,22,177,13,78,65,FALSE
6711,76,20,63,9,72,63,FALSE
6712,83,19,64,8,28,20,FALSE
6713,123,17,137,5,62,57,FALSE
6714,129,5,233,2,76,74,FALSE
6715,69,3,224,8,75,67,FALSE
6716,57,20,186,6,72,66,FALSE
6717,155,20,73,2,23,21,FALSE
6718,145,7,249,4,75,71,FALSE
6719,37,24,244,17,28,11,FALSE
6720,180,12,290,1,79,78,FALSE
6721,140,13,196,17,83,66,FALSE
6722,165,30,90,18,68,50,FALSE
6723,149,3,240,20,74,54,FALSE
6724,200,17,229,18,67,49,FALSE
6725,177,8,62,12,30,18,FALSE
6726,163,17,231,11,54,43,FALSE
6727,37,1,166,9,44,35,FALSE
6728,67,22,55,1,45,44,FALSE
6729,167,2,132,19,58,39,FALSE
6730,196,21,37,19,21,2,FALSE
6731,142,18,292,4,54,50,FALSE
6732,188,12,197,11,100,89,FALSE
6733,133,18,262,11,29,18,FALSE
6734,25,3,285,2,68,66,True
6735,159,6,62,3,81,78,FALSE
6736,53,24,130,16,54,38,FALSE
6737,132,21,59,7,61,54,FALSE
6738,126,23,29,20,26,6,FALSE
6739,171,11,146,11,71,60,True
6740,117,5,234,13,69,56,FALSE
6741,44,11,126,3,95,92,FALSE
6742,121,15,297,7,24,17,FALSE
6743,116,9,182,12,68,56,FALSE
6744,50,24,73,18,26,8,FALSE
6745,69,16,300,1,84,83,FALSE
6746,110,20,133,16,48,32,FALSE
6747,25,30,255,18,58,40,FALSE
6748,195,21,279,2,73,71,FALSE
6749,140,26,66,14,44,30,FALSE
6750,177,21,188,9,66,57,FALSE
6751,96,25,254,8,77,69,FALSE
6752,151,9,66,4,43,39,FALSE
6753,145,16,114,4,96,92,FALSE
6754,82,5,280,13,41,28,FALSE
6755,194,10,121,8,75,67,FALSE
6756,132,2,221,15,46,31,FALSE
6757,71,5,253,10,88,78,FALSE
6758,101,18,290,18,39,21,FALSE
6759,98,13,22,4,77,73,FALSE
6760,126,12,46,8,41,33,FALSE
6761,69,7,200,17,39,22,FALSE
6762,191,28,84,7,96,89,FALSE
6763,49,12,26,1,67,66,FALSE
6764,150,13,103,2,99,97,FALSE
6765,49,26,170,2,39,37,FALSE
6766,109,14,170,8,50,42,FALSE
6767,78,15,23,14,83,69,FALSE
6768,38,14,51,13,88,75,FALSE
6769,61,29,67,6,51,45,FALSE
6770,176,24,85,11,27,16,FALSE
6771,80,25,112,19,99,80,FALSE
6772,149,22,286,7,70,63,FALSE
6773,75,25,24,11,91,80,FALSE
6774,37,28,262,20,55,35,FALSE
6775,163,8,160,6,32,26,FALSE
6776,92,28,193,8,46,38,FALSE
6777,170,16,280,9,25,16,FALSE
6778,77,13,232,1,97,96,FALSE
6779,186,25,158,6,34,28,FALSE
6780,129,6,148,13,41,28,FALSE
6781,99,14,159,14,43,29,FALSE
6782,34,7,37,9,42,33,FALSE
6783,67,22,143,20,21,1,FALSE
6784,20,24,133,15,33,18,FALSE
6785,29,27,253,20,44,24,FALSE
6786,44,16,202,11,56,45,FALSE
6787,103,1,108,5,59,54,FALSE
6788,125,28,141,15,42,27,FALSE
6789,78,28,262,4,47,43,FALSE
6790,104,11,24,18,85,67,FALSE
6791,144,27,44,11,90,79,True
6792,178,4,239,4,20,16,True
6793,86,26,52,19,36,17,FALSE
6794,91,27,52,15,21,6,FALSE
6795,29,30,33,6,28,22,FALSE
6796,118,28,22,15,96,81,FALSE
6797,169,17,259,9,28,19,True
6798,38,12,169,14,90,76,FALSE
6799,47,5,143,16,84,68,FALSE
6800,45,4,239,14,30,16,FALSE
6801,161,24,103,3,60,57,FALSE
6802,190,5,30,2,71,69,FALSE
6803,28,29,286,6,26,20,FALSE
6804,98,5,195,15,66,51,FALSE
6805,99,5,88,10,73,63,FALSE
6806,37,7,262,3,78,75,FALSE
6807,46,14,120,5,23,18,FALSE
6808,24,18,220,13,26,13,FALSE
6809,71,7,114,20,100,80,FALSE
6810,199,7,141,8,37,29,FALSE
6811,157,5,134,17,83,66,FALSE
6812,94,11,229,8,40,32,FALSE
6813,35,5,67,15,52,37,FALSE
6814,197,25,146,9,84,75,FALSE
6815,171,5,293,6,96,90,FALSE
6816,140,21,204,8,36,28,FALSE
6817,75,21,234,7,96,89,FALSE
6818,87,3,142,2,43,41,FALSE
6819,169,2,235,14,42,28,FALSE
6820,77,8,245,7,78,71,FALSE
6821,92,4,42,4,67,63,FALSE
6822,164,16,238,1,45,44,FALSE
6823,131,11,30,10,28,18,FALSE
6824,167,11,200,8,60,52,FALSE
6825,188,25,277,13,86,73,FALSE
6826,78,1,121,18,74,56,FALSE
6827,101,5,93,6,32,26,FALSE
6828,196,1,210,20,27,7,FALSE
6829,175,2,38,2,36,34,FALSE
6830,111,4,197,20,95,75,FALSE
6831,169,25,117,10,40,30,FALSE
6832,153,30,198,9,73,64,FALSE
6833,175,9,171,5,98,93,FALSE
6834,144,16,234,6,55,49,FALSE
6835,163,23,218,6,23,17,FALSE
6836,57,29,147,19,69,50,FALSE
6837,97,20,143,15,42,27,FALSE
6838,96,12,83,17,85,68,FALSE
6839,104,12,137,10,49,39,FALSE
6840,138,21,175,12,61,49,FALSE
6841,95,16,141,20,45,25,FALSE
6842,26,25,183,12,66,54,FALSE
6843,40,25,248,11,85,74,FALSE
6844,153,6,126,13,44,31,FALSE
6845,124,26,252,18,46,28,FALSE
6846,120,20,286,18,49,31,FALSE
6847,57,9,21,18,88,70,FALSE
6848,134,29,279,10,31,21,FALSE
6849,49,2,262,8,21,13,FALSE
6850,37,9,224,8,20,12,FALSE
6851,98,29,112,11,100,89,True
6852,64,12,64,13,58,45,FALSE
6853,172,9,88,17,73,56,FALSE
6854,40,23,221,7,94,87,FALSE
6855,28,9,67,6,89,83,FALSE
6856,159,30,290,2,42,40,FALSE
6857,158,5,280,14,63,49,FALSE
6858,85,13,231,13,90,77,FALSE
6859,189,14,109,20,28,8,True
6860,70,13,39,5,39,34,FALSE
6861,85,24,240,15,53,38,FALSE
6862,114,26,66,15,88,73,FALSE
6863,101,10,291,6,30,24,FALSE
6864,197,11,51,9,95,86,FALSE
6865,70,23,55,9,87,78,FALSE
6866,191,9,141,6,47,41,FALSE
6867,72,8,103,11,89,78,FALSE
6868,163,20,164,20,81,61,True
6869,182,24,298,1,87,86,FALSE
6870,134,14,62,11,93,82,FALSE
6871,165,19,298,17,90,73,FALSE
6872,181,19,122,17,46,29,FALSE
6873,199,26,237,20,63,43,FALSE
6874,188,3,136,11,37,26,FALSE
6875,121,15,46,10,54,44,FALSE
6876,118,28,295,3,75,72,FALSE
6877,99,19,22,4,26,22,FALSE
6878,38,12,120,13,27,14,FALSE
6879,105,12,114,6,63,57,FALSE
6880,112,22,270,6,52,46,FALSE
6881,104,21,32,5,35,30,FALSE
6882,164,29,84,1,42,41,FALSE
6883,115,22,176,16,45,29,FALSE
6884,126,9,177,15,97,82,FALSE
6885,82,13,31,20,67,47,FALSE
6886,40,20,280,5,84,79,FALSE
6887,185,25,205,14,70,56,FALSE
6888,157,7,247,3,72,69,FALSE
6889,102,4,233,8,25,17,True
6890,152,21,124,7,85,78,FALSE
6891,108,18,172,14,47,33,FALSE
6892,124,21,151,8,27,19,FALSE
6893,113,23,247,10,75,65,FALSE
6894,158,17,133,5,62,57,FALSE
6895,108,27,155,5,79,74,FALSE
6896,194,17,54,14,28,14,FALSE
6897,154,22,88,12,24,12,FALSE
6898,174,30,82,1,37,36,FALSE
6899,178,25,242,5,99,94,FALSE
6900,141,25,84,9,71,62,FALSE
6901,67,30,284,12,22,10,FALSE
6902,190,8,144,19,37,18,FALSE
6903,24,7,272,11,68,57,FALSE
6904,198,21,54,18,64,46,FALSE
6905,53,25,247,11,76,65,FALSE
6906,144,21,300,15,45,30,FALSE
6907,64,16,198,15,99,84,FALSE
6908,58,5,144,7,35,28,FALSE
6909,136,29,170,18,38,20,FALSE
6910,114,17,37,17,90,73,FALSE
6911,59,27,95,15,80,65,FALSE
6912,114,22,253,3,40,37,FALSE
6913,109,22,233,5,45,40,True
6914,86,29,28,5,80,75,FALSE
6915,117,3,189,2,95,93,FALSE
6916,110,7,115,15,53,38,FALSE
6917,129,14,112,6,52,46,FALSE
6918,32,4,128,15,48,33,FALSE
6919,109,2,201,20,28,8,FALSE
6920,152,21,95,10,28,18,FALSE
6921,103,10,273,20,90,70,FALSE
6922,100,7,28,7,81,74,FALSE
6923,133,24,136,18,46,28,FALSE
6924,66,26,165,1,87,86,True
6925,37,16,70,7,88,81,FALSE
6926,111,2,58,18,32,14,FALSE
6927,169,27,285,8,67,59,FALSE
6928,82,20,183,18,74,56,FALSE
6929,152,24,300,19,89,70,FALSE
6930,81,16,79,6,36,30,FALSE
6931,108,3,278,11,38,27,FALSE
6932,156,13,177,8,40,32,FALSE
6933,21,24,259,5,89,84,FALSE
6934,91,5,127,7,75,68,FALSE
6935,147,26,66,17,62,45,FALSE
6936,151,28,124,3,62,59,FALSE
6937,79,30,205,10,65,55,FALSE
6938,146,24,105,14,60,46,FALSE
6939,141,27,286,2,71,69,FALSE
6940,122,20,145,1,47,46,FALSE
6941,147,7,91,8,55,47,FALSE
6942,157,11,82,19,65,46,FALSE
6943,58,14,55,5,71,66,FALSE
6944,147,14,229,7,32,25,FALSE
6945,103,1,183,2,48,46,FALSE
6946,60,16,284,6,90,84,FALSE
6947,149,25,64,8,24,16,FALSE
6948,92,21,283,7,57,50,FALSE
6949,74,30,204,18,63,45,FALSE
6950,137,28,150,10,71,61,FALSE
6951,187,14,170,12,70,58,FALSE
6952,37,24,266,11,98,87,FALSE
6953,100,9,53,7,88,81,FALSE
6954,162,13,283,13,32,19,FALSE
6955,167,11,108,12,92,80,FALSE
6956,136,28,118,16,95,79,FALSE
6957,54,8,165,6,90,84,FALSE
6958,168,9,162,19,87,68,FALSE
6959,35,15,130,17,75,58,True
6960,50,22,70,10,55,45,FALSE
6961,137,3,202,12,39,27,FALSE
6962,185,8,120,7,26,19,FALSE
6963,180,23,195,18,91,73,FALSE
6964,90,10,140,7,38,31,FALSE
6965,71,13,283,6,65,59,FALSE
6966,73,11,266,17,31,14,FALSE
6967,61,22,297,9,76,67,FALSE
6968,122,30,115,18,44,26,FALSE
6969,168,30,66,20,97,77,FALSE
6970,169,3,160,2,71,69,FALSE
6971,147,16,29,13,47,34,FALSE
6972,48,2,71,10,86,76,FALSE
6973,24,15,286,17,43,26,FALSE
6974,127,12,81,1,47,46,True
6975,79,16,24,1,74,73,FALSE
6976,90,11,239,15,49,34,FALSE
6977,74,11,39,13,63,50,FALSE
6978,151,6,56,6,97,91,FALSE
6979,191,6,195,5,32,27,FALSE
6980,131,21,284,13,84,71,FALSE
6981,62,14,23,19,48,29,FALSE
6982,194,6,217,14,28,14,FALSE
6983,193,21,192,14,81,67,FALSE
6984,102,8,126,15,48,33,FALSE
6985,176,3,59,17,51,34,FALSE
6986,26,18,190,18,23,5,FALSE
6987,50,24,163,6,92,86,FALSE
6988,187,4,293,15,40,25,FALSE
6989,55,7,179,2,31,29,FALSE
6990,190,28,40,5,79,74,FALSE
6991,54,25,95,8,20,12,FALSE
6992,193,7,142,6,85,79,FALSE
6993,56,17,41,7,84,77,FALSE
6994,145,15,226,18,21,3,FALSE
6995,41,30,262,16,27,11,FALSE
6996,124,4,136,19,30,11,FALSE
6997,138,12,148,2,87,85,FALSE
6998,182,4,256,7,73,66,FALSE
6999,58,7,284,11,60,49,FALSE
7000,23,10,94,13,26,13,FALSE
7001,86,27,63,4,52,48,FALSE
7002,152,3,158,13,85,72,FALSE
7003,183,28,295,18,98,80,FALSE
7004,173,5,121,8,39,31,FALSE
7005,120,17,168,16,35,19,FALSE
7006,130,4,123,4,51,47,FALSE
7007,156,2,265,5,79,74,FALSE
7008,176,17,267,17,82,65,FALSE
7009,143,9,260,11,89,78,FALSE
7010,168,30,286,17,59,42,FALSE
7011,177,1,170,1,99,98,FALSE
7012,57,29,132,1,42,41,FALSE
7013,157,15,249,17,99,82,FALSE
7014,183,22,245,16,64,48,FALSE
7015,192,18,263,5,45,40,FALSE
7016,133,28,204,14,41,27,FALSE
7017,163,13,171,12,67,55,FALSE
7018,93,21,29,13,70,57,FALSE
7019,76,23,132,20,93,73,FALSE
7020,77,29,265,8,46,38,FALSE
7021,31,8,28,16,36,20,FALSE
7022,178,7,58,12,43,31,FALSE
7023,57,8,35,6,34,28,FALSE
7024,22,16,284,2,36,34,FALSE
7025,33,3,163,6,83,77,FALSE
7026,142,6,23,18,56,38,FALSE
7027,66,24,209,12,61,49,FALSE
7028,103,7,211,5,31,26,FALSE
7029,53,14,111,12,41,29,FALSE
7030,82,13,256,6,27,21,FALSE
7031,35,9,144,13,32,19,FALSE
7032,71,23,296,9,25,16,FALSE
7033,100,21,20,1,94,93,FALSE
7034,109,23,223,15,67,52,FALSE
7035,23,26,261,20,89,69,FALSE
7036,122,1,152,11,100,89,FALSE
7037,131,2,162,2,80,78,FALSE
7038,104,2,263,11,84,73,FALSE
7039,97,9,217,18,57,39,FALSE
7040,83,8,210,10,23,13,FALSE
7041,67,30,20,11,72,61,FALSE
7042,191,19,34,13,73,60,FALSE
7043,62,21,88,10,83,73,FALSE
7044,35,26,130,12,29,17,FALSE
7045,105,8,76,7,54,47,FALSE
7046,138,30,276,10,49,39,FALSE
7047,45,16,35,3,52,49,FALSE
7048,188,28,291,1,28,27,FALSE
7049,22,21,280,17,79,62,FALSE
7050,71,15,53,19,33,14,FALSE
7051,123,19,296,17,51,34,FALSE
7052,106,24,271,13,100,87,FALSE
7053,160,21,198,3,68,65,FALSE
7054,72,1,112,17,82,65,FALSE
7055,87,3,66,5,58,53,FALSE
7056,24,30,276,11,90,79,FALSE
7057,166,3,157,13,52,39,FALSE
7058,73,2,68,19,43,24,FALSE
7059,85,22,148,16,33,17,FALSE
7060,32,4,68,18,94,76,True
7061,153,24,20,6,27,21,FALSE
7062,173,29,295,2,97,95,FALSE
7063,20,14,143,3,63,60,FALSE
7064,47,3,241,20,59,39,FALSE
7065,196,10,130,4,39,35,FALSE
7066,97,2,81,14,58,44,FALSE
7067,164,14,247,2,53,51,FALSE
7068,87,29,89,8,62,54,FALSE
7069,27,2,202,5,40,35,FALSE
7070,88,20,294,18,75,57,FALSE
7071,152,4,54,17,86,69,FALSE
7072,54,5,206,19,95,76,FALSE
7073,64,10,187,17,68,51,FALSE
7074,56,7,234,9,37,28,FALSE
7075,104,16,256,11,92,81,FALSE
7076,85,4,252,9,55,46,FALSE
7077,44,14,159,4,90,86,FALSE
7078,120,25,55,3,97,94,FALSE
7079,45,23,37,14,94,80,FALSE
7080,140,30,132,4,41,37,FALSE
7081,82,15,113,12,23,11,FALSE
7082,142,2,112,17,32,15,FALSE
7083,87,5,198,7,95,88,FALSE
7084,55,14,122,5,35,30,FALSE
7085,36,15,142,13,23,10,FALSE
7086,135,1,138,18,22,4,FALSE
7087,100,7,48,14,24,10,FALSE
7088,174,29,291,14,80,66,FALSE
7089,191,8,50,13,47,34,FALSE
7090,46,17,166,19,49,30,FALSE
7091,147,1,170,12,66,54,FALSE
7092,66,28,27,20,81,61,FALSE
7093,112,12,196,6,30,24,FALSE
7094,40,4,27,3,59,56,True
7095,194,29,128,15,38,23,FALSE
7096,44,30,159,9,92,83,FALSE
7097,77,18,125,12,26,14,FALSE
7098,52,11,262,18,78,60,FALSE
7099,23,16,136,7,26,19,FALSE
7100,154,30,145,19,82,63,FALSE
7101,113,25,285,14,54,40,FALSE
7102,176,5,159,9,74,65,FALSE
7103,100,17,51,7,21,14,FALSE
7104,75,11,183,3,96,93,FALSE
7105,42,9,188,10,91,81,FALSE
7106,149,3,207,3,59,56,FALSE
7107,120,11,114,7,50,43,FALSE
7108,197,5,161,14,24,10,FALSE
7109,172,12,298,16,44,28,FALSE
7110,41,3,86,8,59,51,FALSE
7111,143,9,152,10,34,24,FALSE
7112,180,27,188,12,28,16,FALSE
7113,61,14,269,13,72,59,FALSE
7114,193,14,193,15,66,51,FALSE
7115,185,9,37,13,94,81,FALSE
7116,69,15,150,4,99,95,FALSE
7117,117,20,131,9,84,75,FALSE
7118,112,15,135,6,65,59,FALSE
7119,66,10,257,9,54,45,FALSE
7120,137,8,57,4,86,82,FALSE
7121,98,19,152,16,68,52,FALSE
7122,33,18,270,15,27,12,FALSE
7123,66,19,290,3,31,28,FALSE
7124,199,5,98,15,96,81,FALSE
7125,175,26,129,16,97,81,FALSE
7126,27,15,249,6,21,15,FALSE
7127,57,4,147,11,82,71,FALSE
7128,174,14,248,14,79,65,FALSE
7129,101,20,200,11,85,74,FALSE
7130,31,10,292,15,41,26,FALSE
7131,159,30,109,13,66,53,FALSE
7132,41,10,253,3,87,84,FALSE
7133,59,21,242,12,58,46,FALSE
7134,155,22,148,16,55,39,FALSE
7135,183,8,35,15,62,47,FALSE
7136,181,9,43,13,30,17,FALSE
7137,146,24,284,11,66,55,FALSE
7138,82,26,151,7,78,71,FALSE
7139,43,14,43,11,29,18,FALSE
7140,115,13,138,3,55,52,FALSE
7141,102,5,282,4,43,39,FALSE
7142,84,22,238,19,88,69,FALSE
7143,136,29,130,2,87,85,FALSE
7144,98,17,221,20,26,6,FALSE
7145,121,3,223,11,90,79,FALSE
7146,165,14,186,4,70,66,FALSE
7147,31,13,176,6,37,31,FALSE
7148,151,4,258,11,20,9,FALSE
7149,138,24,78,14,45,31,FALSE
7150,69,30,256,12,82,70,FALSE
7151,117,3,158,3,30,27,FALSE
7152,46,23,63,1,62,61,FALSE
7153,65,26,138,7,63,56,FALSE
7154,93,4,57,6,53,47,FALSE
7155,89,24,178,2,82,80,FALSE
7156,163,26,242,17,56,39,FALSE
7157,77,6,67,12,54,42,FALSE
7158,138,11,268,18,65,47,FALSE
7159,165,30,293,14,35,21,FALSE
7160,138,1,273,2,27,25,FALSE
7161,102,12,36,1,43,42,FALSE
7162,141,21,36,7,21,14,FALSE
7163,199,26,45,2,39,37,FALSE
7164,145,12,136,2,96,94,FALSE
7165,140,14,140,16,48,32,FALSE
7166,93,1,36,7,78,71,FALSE
7167,108,20,300,2,60,58,FALSE
7168,86,2,194,20,39,19,FALSE
7169,86,10,264,18,51,33,FALSE
7170,116,24,49,18,69,51,True
7171,164,16,148,2,24,22,FALSE
7172,90,3,117,19,99,80,FALSE
7173,71,8,243,9,30,21,FALSE
7174,82,26,93,13,90,77,FALSE
7175,71,15,177,9,20,11,FALSE
7176,50,27,201,11,33,22,FALSE
7177,160,2,60,6,71,65,True
7178,93,30,286,14,64,50,FALSE
7179,117,26,155,20,47,27,FALSE
7180,56,28,164,14,94,80,FALSE
7181,104,30,116,4,33,29,FALSE
7182,189,14,125,10,58,48,FALSE
7183,197,29,66,16,83,67,FALSE
7184,63,11,20,14,59,45,FALSE
7185,80,20,166,20,33,13,FALSE
7186,110,5,261,18,21,3,FALSE
7187,175,28,87,4,84,80,FALSE
7188,105,25,142,11,81,70,FALSE
7189,190,3,133,3,46,43,FALSE
7190,71,21,118,16,69,53,FALSE
7191,124,7,62,6,87,81,FALSE
7192,119,16,87,1,81,80,FALSE
7193,57,17,148,10,100,90,FALSE
7194,144,2,272,10,47,37,FALSE
7195,68,2,111,7,87,80,FALSE
7196,105,24,290,19,76,57,FALSE
7197,170,26,202,18,41,23,FALSE
7198,67,26,268,13,52,39,FALSE
7199,70,1,67,16,44,28,FALSE
7200,124,25,196,7,24,17,FALSE
7201,133,10,179,17,63,46,FALSE
7202,110,13,46,18,30,12,FALSE
7203,161,7,238,13,72,59,FALSE
7204,32,1,193,14,65,51,FALSE
7205,200,12,236,3,27,24,FALSE
7206,24,18,215,17,82,65,FALSE
7207,158,6,201,5,82,77,True
7208,110,6,151,19,64,45,FALSE
7209,50,17,26,16,45,29,FALSE
7210,196,8,51,8,81,73,FALSE
7211,72,10,25,15,81,66,FALSE
7212,133,12,281,10,44,34,FALSE
7213,62,29,128,1,32,31,FALSE
7214,70,14,197,18,77,59,FALSE
7215,117,21,62,10,41,31,FALSE
7216,172,30,202,4,65,61,FALSE
7217,146,22,95,19,76,57,FALSE
7218,115,29,132,16,75,59,FALSE
7219,27,7,168,4,22,18,FALSE
7220,44,7,165,13,23,10,FALSE
7221,170,10,83,9,49,40,FALSE
7222,200,9,36,5,42,37,FALSE
7223,59,7,27,9,50,41,FALSE
7224,73,6,217,4,62,58,FALSE
7225,79,19,209,19,51,32,FALSE
7226,21,24,249,7,83,76,FALSE
7227,174,28,29,7,51,44,True
7228,118,24,228,13,53,40,FALSE
7229,112,5,223,18,57,39,FALSE
7230,117,3,117,5,95,90,FALSE
7231,23,2,233,9,54,45,FALSE
7232,64,22,270,5,20,15,FALSE
7233,176,15,292,9,95,86,FALSE
7234,131,13,62,18,69,51,FALSE
7235,152,19,158,19,75,56,FALSE
7236,167,26,73,10,39,29,FALSE
7237,169,19,168,19,29,10,FALSE
7238,68,14,120,17,91,74,FALSE
7239,182,21,262,18,77,59,FALSE
7240,46,25,71,10,63,53,FALSE
7241,110,5,154,15,70,55,FALSE
7242,95,18,71,19,36,17,FALSE
7243,53,2,62,7,52,45,True
7244,46,5,135,17,77,60,FALSE
7245,101,13,186,20,78,58,FALSE
7246,57,28,87,6,82,76,FALSE
7247,26,24,101,11,34,23,FALSE
7248,185,8,54,12,99,87,FALSE
7249,171,20,179,20,50,30,FALSE
7250,108,17,38,17,25,8,FALSE
7251,92,10,130,3,37,34,FALSE
7252,90,12,157,20,63,43,FALSE
7253,189,15,256,16,49,33,True
7254,72,1,290,20,72,52,FALSE
7255,138,15,214,12,26,14,FALSE
7256,168,21,274,10,81,71,FALSE
7257,94,5,254,20,61,41,FALSE
7258,28,13,81,15,28,13,FALSE
7259,191,18,83,10,58,48,FALSE
7260,136,25,162,7,96,89,FALSE
7261,190,13,187,16,39,23,FALSE
7262,64,24,128,14,99,85,FALSE
7263,73,13,282,19,64,45,FALSE
7264,140,25,83,15,22,7,FALSE
7265,82,11,267,15,70,55,FALSE
7266,35,19,30,6,99,93,FALSE
7267,169,2,187,2,40,38,FALSE
7268,103,18,295,17,47,30,FALSE
7269,194,15,82,20,63,43,FALSE
7270,52,20,243,2,71,69,FALSE
7271,44,25,238,20,95,75,FALSE
7272,48,27,208,14,76,62,FALSE
7273,166,21,236,3,92,89,FALSE
7274,77,11,44,18,22,4,FALSE
7275,185,27,270,16,65,49,FALSE
7276,68,1,224,14,20,6,FALSE
7277,29,21,220,11,68,57,FALSE
7278,91,24,72,9,57,48,FALSE
7279,191,14,199,11,69,58,FALSE
7280,168,23,230,17,91,74,FALSE
7281,87,8,150,5,58,53,FALSE
7282,109,14,188,17,66,49,FALSE
7283,53,14,98,13,69,56,FALSE
7284,170,24,260,20,35,15,FALSE
7285,40,26,67,2,79,77,FALSE
7286,23,19,237,19,42,23,FALSE
7287,145,11,222,1,53,52,FALSE
7288,173,20,242,2,29,27,FALSE
7289,104,16,267,2,91,89,FALSE
7290,84,2,134,5,61,56,FALSE
7291,68,27,244,16,67,51,FALSE
7292,188,14,236,13,65,52,FALSE
7293,138,14,113,11,38,27,FALSE
7294,98,24,139,18,51,33,FALSE
7295,199,27,47,2,90,88,FALSE
7296,139,13,122,16,73,57,FALSE
7297,114,13,112,10,58,48,FALSE
7298,166,12,206,19,53,34,FALSE
7299,47,13,109,17,22,5,FALSE
7300,122,2,128,15,72,57,FALSE
7301,64,25,227,15,40,25,FALSE
7302,140,3,45,16,80,64,FALSE
7303,176,3,137,2,32,30,FALSE
7304,46,16,274,9,48,39,True
7305,112,14,153,4,67,63,FALSE
7306,47,30,20,2,50,48,FALSE
7307,47,19,243,7,90,83,FALSE
7308,79,18,296,16,92,76,FALSE
7309,192,18,35,13,74,61,FALSE
7310,48,5,126,3,71,68,FALSE
7311,106,12,115,3,24,21,FALSE
7312,181,8,218,13,23,10,FALSE
7313,193,3,51,13,73,60,FALSE
7314,75,18,279,12,65,53,FALSE
7315,100,11,140,16,93,77,FALSE
7316,163,14,124,12,63,51,FALSE
7317,96,18,215,16,32,16,FALSE
7318,126,14,252,13,32,19,FALSE
7319,182,24,275,19,78,59,FALSE
7320,162,12,154,14,75,61,FALSE
7321,136,19,124,2,65,63,FALSE
7322,102,12,191,3,33,30,FALSE
7323,165,12,200,3,90,87,FALSE
7324,29,15,95,9,32,23,FALSE
7325,128,16,249,4,92,88,FALSE
7326,145,9,176,10,36,26,FALSE
7327,196,11,140,1,83,82,FALSE
7328,160,15,54,17,52,35,FALSE
7329,115,1,62,16,26,10,FALSE
7330,126,9,150,3,26,23,FALSE
7331,68,9,30,17,78,61,FALSE
7332,150,2,55,13,98,85,FALSE
7333,39,8,80,16,99,83,FALSE
7334,61,4,126,11,77,66,FALSE
7335,175,30,182,14,33,19,FALSE
7336,172,29,138,15,31,16,FALSE
7337,149,22,269,8,20,12,FALSE
7338,157,16,29,9,65,56,FALSE
7339,193,25,211,10,78,68,FALSE
7340,38,26,230,6,87,81,FALSE
7341,152,14,246,7,35,28,FALSE
7342,117,18,152,12,97,85,True
7343,179,19,242,13,77,64,FALSE
7344,67,22,243,12,88,76,FALSE
7345,94,9,299,19,60,41,FALSE
7346,37,17,53,8,82,74,FALSE
7347,60,4,134,17,45,28,FALSE
7348,74,11,153,7,85,78,FALSE
7349,145,6,199,5,65,60,FALSE
7350,87,20,88,7,76,69,FALSE
7351,150,17,78,7,49,42,FALSE
7352,174,26,118,20,35,15,FALSE
7353,50,1,162,3,67,64,FALSE
7354,188,14,98,18,91,73,FALSE
7355,174,18,22,11,24,13,FALSE
7356,94,7,226,14,78,64,FALSE
7357,112,2,210,10,45,35,FALSE
7358,181,27,25,14,38,24,True
7359,24,13,201,7,70,63,FALSE
7360,155,17,242,15,45,30,FALSE
7361,193,29,256,11,95,84,FALSE
7362,108,26,296,18,37,19,FALSE
7363,33,20,151,6,92,86,FALSE
7364,54,9,98,12,89,77,FALSE
7365,148,16,239,9,94,85,FALSE
7366,28,4,191,19,57,38,FALSE
7367,34,26,138,8,55,47,FALSE
7368,168,11,27,20,21,1,FALSE
7369,168,15,214,7,41,34,FALSE
7370,27,6,53,18,57,39,FALSE
7371,102,20,196,10,78,68,FALSE
7372,159,12,137,4,21,17,FALSE
7373,140,23,185,4,27,23,FALSE
7374,153,21,284,12,96,84,FALSE
7375,26,15,30,2,90,88,FALSE
7376,187,22,151,17,61,44,FALSE
7377,38,12,132,4,42,38,FALSE
7378,107,4,206,4,21,17,FALSE
7379,27,19,279,14,99,85,FALSE
7380,78,13,292,16,52,36,FALSE
7381,75,6,102,17,47,30,FALSE
7382,97,20,105,6,31,25,FALSE
7383,177,18,288,8,96,88,FALSE
7384,109,25,128,14,69,55,FALSE
7385,121,11,137,8,61,53,FALSE
7386,156,6,198,17,36,19,FALSE
7387,80,16,50,14,72,58,FALSE
7388,155,6,266,16,20,4,True
7389,112,17,159,8,38,30,FALSE
7390,54,20,263,9,64,55,FALSE
7391,31,28,25,18,86,68,FALSE
7392,51,18,245,12,94,82,FALSE
7393,180,2,207,7,89,82,FALSE
7394,111,23,226,4,56,52,FALSE
7395,183,24,41,9,96,87,FALSE
7396,158,3,191,15,72,57,FALSE
7397,95,22,179,19,61,42,FALSE
7398,69,17,175,3,55,52,True
7399,138,29,108,8,28,20,FALSE
7400,117,15,237,1,54,53,FALSE
7401,82,9,260,16,68,52,FALSE
7402,191,12,78,14,24,10,FALSE
7403,151,30,78,17,69,52,FALSE
7404,30,11,253,1,81,80,FALSE
7405,191,12,103,3,76,73,FALSE
7406,141,27,137,8,43,35,FALSE
7407,64,29,133,14,75,61,FALSE
7408,33,1,49,16,68,52,FALSE
7409,132,28,61,17,23,6,FALSE
7410,168,28,270,6,31,25,FALSE
7411,133,25,267,17,68,51,FALSE
7412,63,15,291,4,54,50,FALSE
7413,66,1,214,16,82,66,FALSE
7414,90,17,44,2,31,29,FALSE
7415,192,21,105,3,89,86,FALSE
7416,199,10,235,2,94,92,FALSE
7417,39,22,220,17,45,28,FALSE
7418,182,21,149,15,67,52,FALSE
7419,72,20,20,7,47,40,FALSE
7420,180,28,201,20,61,41,FALSE
7421,197,28,86,5,41,36,FALSE
7422,67,19,283,8,62,54,FALSE
7423,118,6,204,13,42,29,FALSE
7424,107,13,194,8,38,30,FALSE
7425,45,30,299,12,77,65,FALSE
7426,105,1,109,15,47,32,FALSE
7427,175,9,235,5,46,41,FALSE
7428,175,25,53,7,80,73,FALSE
7429,99,22,291,8,65,57,FALSE
7430,126,8,39,7,76,69,FALSE
7431,45,17,270,4,22,18,FALSE
7432,125,27,71,8,71,63,FALSE
7433,20,19,246,4,81,77,FALSE
7434,143,23,209,16,52,36,FALSE
7435,199,2,297,5,42,37,FALSE
7436,140,8,63,7,24,17,FALSE
7437,51,27,60,11,67,56,FALSE
7438,183,16,90,6,43,37,FALSE
7439,76,9,131,1,33,32,FALSE
7440,143,17,172,18,78,60,FALSE
7441,140,21,178,17,94,77,FALSE
7442,148,11,230,15,30,15,FALSE
7443,178,15,207,15,42,27,FALSE
7444,126,14,36,4,74,70,FALSE
7445,101,11,149,19,84,65,FALSE
7446,144,6,121,6,64,58,FALSE
7447,85,10,289,3,28,25,FALSE
7448,85,13,217,20,32,12,FALSE
7449,118,23,88,7,61,54,FALSE
7450,49,8,60,5,92,87,FALSE
7451,147,22,214,17,82,65,FALSE
7452,167,5,219,18,75,57,FALSE
7453,140,29,286,13,57,44,FALSE
7454,167,17,34,12,91,79,FALSE
7455,55,27,21,18,91,73,FALSE
7456,44,7,272,11,34,23,FALSE
7457,167,20,274,17,42,25,FALSE
7458,57,25,236,18,36,18,FALSE
7459,99,13,246,19,27,8,FALSE
7460,177,29,258,8,25,17,FALSE
7461,159,7,55,13,67,54,FALSE
7462,24,27,194,12,56,44,FALSE
7463,26,19,133,12,45,33,FALSE
7464,53,4,211,12,62,50,FALSE
7465,29,8,255,4,88,84,FALSE
7466,50,20,299,16,73,57,FALSE
7467,198,23,91,14,24,10,FALSE
7468,190,13,23,11,50,39,FALSE
7469,37,8,20,13,78,65,FALSE
7470,151,7,116,2,78,76,FALSE
7471,175,25,260,5,49,44,FALSE
7472,74,19,260,1,60,59,FALSE
7473,52,19,214,6,72,66,FALSE
7474,161,30,236,20,70,50,FALSE
7475,36,12,222,1,77,76,FALSE
7476,24,5,234,4,73,69,FALSE
7477,69,9,289,20,91,71,FALSE
7478,195,9,223,14,66,52,FALSE
7479,89,26,53,18,43,25,FALSE
7480,110,6,170,12,76,64,FALSE
7481,25,18,64,16,58,42,FALSE
7482,70,8,291,1,38,37,FALSE
7483,112,6,160,20,54,34,FALSE
7484,196,6,81,14,47,33,FALSE
7485,32,2,218,6,28,22,FALSE
7486,79,23,149,8,35,27,FALSE
7487,189,22,200,14,57,43,FALSE
7488,30,3,269,10,35,25,FALSE
7489,28,11,30,10,58,48,True
7490,186,6,67,17,33,16,FALSE
7491,86,27,20,5,74,69,FALSE
7492,162,7,290,4,91,87,FALSE
7493,86,17,221,16,48,32,FALSE
7494,21,21,29,20,78,58,FALSE
7495,114,14,105,17,94,77,FALSE
7496,199,14,117,18,50,32,FALSE
7497,174,30,237,19,37,18,FALSE
7498,159,25,202,14,65,51,FALSE
7499,141,29,23,17,48,31,FALSE
7500,163,4,251,13,85,72,FALSE
7501,128,15,284,16,93,77,FALSE
7502,119,11,79,7,85,78,FALSE
7503,181,1,115,11,88,77,FALSE
7504,50,3,126,1,90,89,FALSE
7505,154,26,240,19,54,35,FALSE
7506,154,26,102,14,66,52,FALSE
7507,99,8,109,8,63,55,FALSE
7508,126,26,75,13,30,17,FALSE
7509,84,10,207,16,44,28,FALSE
7510,161,21,295,3,28,25,FALSE
7511,126,26,212,14,93,79,FALSE
7512,120,24,38,17,87,70,FALSE
7513,84,6,69,16,31,15,FALSE
7514,61,16,206,12,86,74,FALSE
7515,182,23,209,15,85,70,FALSE
7516,162,10,241,1,48,47,FALSE
7517,24,8,242,9,71,62,FALSE
7518,28,12,173,3,53,50,FALSE
7519,32,2,96,7,84,77,FALSE
7520,86,12,43,4,23,19,FALSE
7521,28,17,211,10,79,69,FALSE
7522,176,3,159,1,58,57,FALSE
7523,144,13,55,14,85,71,FALSE
7524,27,2,26,13,82,69,FALSE
7525,122,6,280,8,80,72,FALSE
7526,146,18,161,1,49,48,FALSE
7527,103,25,37,6,62,56,FALSE
7528,33,20,263,2,34,32,FALSE
7529,153,19,264,15,84,69,FALSE
7530,65,9,109,6,94,88,FALSE
7531,38,12,81,13,54,41,FALSE
7532,176,26,150,5,44,39,FALSE
7533,190,7,40,18,49,31,FALSE
7534,112,28,115,17,63,46,True
7535,133,25,240,2,56,54,FALSE
7536,112,6,300,4,58,54,FALSE
7537,64,27,23,11,89,78,FALSE
7538,133,9,290,10,33,23,FALSE
7539,144,13,201,5,96,91,FALSE
7540,44,14,26,11,66,55,FALSE
7541,141,1,245,20,65,45,FALSE
7542,113,3,241,6,39,33,FALSE
7543,105,23,224,14,94,80,FALSE
7544,125,1,64,1,65,64,FALSE
7545,90,1,58,8,83,75,FALSE
7546,175,23,77,16,46,30,FALSE
7547,171,2,92,14,96,82,FALSE
7548,102,1,234,17,75,58,FALSE
7549,126,13,63,17,23,6,FALSE
7550,61,26,235,16,92,76,FALSE
7551,151,24,27,8,20,12,FALSE
7552,75,25,57,4,96,92,FALSE
7553,80,23,57,10,79,69,FALSE
7554,64,28,227,19,24,5,FALSE
7555,44,4,184,2,89,87,FALSE
7556,132,5,182,5,92,87,FALSE
7557,162,7,223,10,87,77,FALSE
7558,111,8,265,17,41,24,FALSE
7559,145,3,94,13,82,69,FALSE
7560,53,1,227,16,94,78,FALSE
7561,28,7,297,17,59,42,FALSE
7562,199,14,95,11,69,58,FALSE
7563,129,5,99,4,57,53,FALSE
7564,189,20,52,7,45,38,FALSE
7565,65,16,189,15,73,58,FALSE
7566,87,19,222,19,30,11,FALSE
7567,118,7,127,20,39,19,FALSE
7568,43,14,206,8,58,50,FALSE
7569,156,10,146,12,52,40,FALSE
7570,81,25,145,14,20,6,FALSE
7571,51,18,41,5,66,61,FALSE
7572,41,25,196,9,37,28,FALSE
7573,163,12,77,20,31,11,FALSE
7574,123,26,174,4,39,35,FALSE
7575,75,23,72,10,60,50,FALSE
7576,94,1,181,9,66,57,FALSE
7577,164,24,237,4,32,28,FALSE
7578,147,14,253,9,47,38,FALSE
7579,177,26,75,10,20,10,FALSE
7580,24,23,214,13,59,46,FALSE
7581,46,26,46,1,43,42,FALSE
7582,137,13,262,4,59,55,FALSE
7583,123,22,289,18,29,11,FALSE
7584,98,26,297,7,98,91,FALSE
7585,75,22,103,7,43,36,FALSE
7586,85,30,87,15,45,30,FALSE
7587,146,22,122,9,44,35,FALSE
7588,97,18,291,13,63,50,FALSE
7589,94,5,119,7,36,29,FALSE
7590,188,27,56,12,83,71,FALSE
7591,107,24,286,12,73,61,FALSE
7592,70,22,232,15,47,32,FALSE
7593,110,16,298,1,20,19,FALSE
7594,102,18,35,10,71,61,FALSE
7595,56,13,240,19,90,71,FALSE
7596,132,4,130,16,69,53,FALSE
7597,68,1,63,18,91,73,FALSE
7598,132,4,218,6,93,87,FALSE
7599,149,4,228,9,76,67,FALSE
7600,60,21,69,7,57,50,FALSE
7601,140,11,100,7,84,77,FALSE
7602,96,13,138,11,67,56,FALSE
7603,24,20,228,10,73,63,FALSE
7604,118,7,176,13,26,13,FALSE
7605,107,7,150,1,52,51,FALSE
7606,167,10,169,6,62,56,FALSE
7607,76,30,252,5,26,21,FALSE
7608,165,8,37,9,69,60,FALSE
7609,20,21,232,11,90,79,FALSE
7610,35,27,125,6,28,22,FALSE
7611,46,7,221,14,44,30,FALSE
7612,137,17,47,15,69,54,FALSE
7613,160,27,74,17,30,13,FALSE
7614,83,11,107,19,97,78,FALSE
7615,149,25,251,13,100,87,FALSE
7616,38,25,105,10,66,56,FALSE
7617,196,23,167,11,63,52,FALSE
7618,22,10,108,14,38,24,FALSE
7619,113,6,73,17,56,39,FALSE
7620,177,26,122,11,88,77,FALSE
7621,23,30,50,1,66,65,FALSE
7622,134,19,70,20,59,39,FALSE
7623,77,15,66,10,31,21,FALSE
7624,67,17,219,12,86,74,FALSE
7625,160,18,140,8,82,74,FALSE
7626,185,17,135,1,59,58,FALSE
7627,63,11,157,19,93,74,FALSE
7628,68,2,220,18,43,25,FALSE
7629,77,9,112,20,97,77,FALSE
7630,170,21,38,8,39,31,FALSE
7631,84,9,96,11,42,31,FALSE
7632,102,16,79,1,79,78,FALSE
7633,39,2,106,20,93,73,FALSE
7634,40,3,247,5,93,88,FALSE
7635,135,3,109,6,52,46,FALSE
7636,54,6,75,10,56,46,FALSE
7637,105,26,108,13,86,73,FALSE
7638,64,27,97,11,23,12,FALSE
7639,200,26,149,2,73,71,FALSE
7640,169,20,218,17,99,82,FALSE
7641,88,16,293,4,21,17,FALSE
7642,103,12,239,15,63,48,FALSE
7643,148,5,278,11,57,46,FALSE
7644,47,14,148,6,44,38,FALSE
7645,176,1,168,17,29,12,FALSE
7646,132,27,25,7,70,63,FALSE
7647,191,1,48,18,45,27,FALSE
7648,44,17,49,17,61,44,FALSE
7649,198,13,220,2,48,46,FALSE
7650,51,29,52,11,68,57,FALSE
7651,187,17,290,1,63,62,FALSE
7652,154,9,48,10,89,79,FALSE
7653,157,16,105,13,65,52,FALSE
7654,145,26,260,5,29,24,FALSE
7655,183,19,255,3,28,25,FALSE
7656,24,15,123,13,65,52,FALSE
7657,77,30,138,15,38,23,FALSE
7658,91,16,141,8,84,76,FALSE
7659,81,7,178,9,54,45,FALSE
7660,42,1,281,3,36,33,FALSE
7661,120,17,170,16,50,34,FALSE
7662,78,29,111,5,91,86,FALSE
7663,139,25,257,13,22,9,FALSE
7664,73,30,189,7,82,75,FALSE
7665,124,17,195,4,87,83,FALSE
7666,124,11,90,14,60,46,FALSE
7667,91,10,46,2,66,64,FALSE
7668,41,19,222,17,53,36,FALSE
7669,113,28,87,3,58,55,FALSE
7670,192,27,82,20,92,72,FALSE
7671,165,20,128,13,45,32,FALSE
7672,111,4,160,7,51,44,FALSE
7673,150,16,40,19,100,81,FALSE
7674,200,24,272,16,58,42,FALSE
7675,25,10,207,7,88,81,FALSE
7676,169,17,148,18,29,11,FALSE
7677,195,3,49,13,90,77,FALSE
7678,67,24,95,17,42,25,FALSE
7679,44,8,94,5,22,17,FALSE
7680,160,29,206,2,94,92,FALSE
7681,186,15,208,14,26,12,FALSE
7682,176,1,218,4,74,70,FALSE
7683,173,2,140,14,90,76,FALSE
7684,73,26,85,7,78,71,FALSE
7685,32,28,179,6,87,81,FALSE
7686,61,10,69,17,85,68,FALSE
7687,91,26,253,3,61,58,FALSE
7688,144,29,210,4,99,95,FALSE
7689,99,22,254,15,43,28,True
7690,185,8,20,6,38,32,FALSE
7691,114,25,42,1,99,98,FALSE
7692,160,19,73,5,56,51,FALSE
7693,104,12,32,17,22,5,FALSE
7694,20,2,114,6,56,50,FALSE
7695,178,21,205,20,74,54,FALSE
7696,124,12,266,4,98,94,FALSE
7697,174,15,196,15,27,12,FALSE
7698,106,15,256,5,62,57,FALSE
7699,137,16,94,12,54,42,FALSE
7700,91,29,92,8,87,79,FALSE
7701,145,25,124,15,76,61,FALSE
7702,68,10,188,7,28,21,FALSE
7703,20,16,50,19,99,80,FALSE
7704,145,6,78,6,92,86,FALSE
7705,191,29,89,19,71,52,FALSE
7706,95,13,174,1,31,30,FALSE
7707,163,3,210,2,43,41,FALSE
7708,102,29,157,2,35,33,FALSE
7709,190,23,172,15,69,54,FALSE
7710,32,2,280,8,45,37,FALSE
7711,194,14,103,17,93,76,FALSE
7712,185,11,212,3,74,71,FALSE
7713,160,1,215,1,49,48,FALSE
7714,78,19,148,11,94,83,FALSE
7715,87,18,50,10,53,43,FALSE
7716,136,29,111,14,42,28,True
7717,122,18,109,17,53,36,True
7718,50,21,263,6,65,59,FALSE
7719,188,16,98,9,86,77,FALSE
7720,42,4,85,15,53,38,FALSE
7721,138,30,215,18,25,7,FALSE
7722,188,18,144,2,62,60,FALSE
7723,135,7,231,8,32,24,FALSE
7724,163,10,38,12,41,29,FALSE
7725,129,30,108,7,51,44,FALSE
7726,109,25,47,9,40,31,FALSE
7727,125,14,141,5,78,73,FALSE
7728,82,17,21,13,66,53,True
7729,39,29,86,13,43,30,FALSE
7730,153,16,52,15,40,25,FALSE
7731,189,17,153,6,85,79,FALSE
7732,30,27,113,4,55,51,FALSE
7733,196,28,192,9,25,16,FALSE
7734,61,5,179,3,85,82,FALSE
7735,163,18,104,8,61,53,FALSE
7736,58,2,146,20,44,24,FALSE
7737,31,14,95,13,70,57,FALSE
7738,38,29,242,4,94,90,FALSE
7739,188,27,274,19,20,1,FALSE
7740,133,8,130,9,66,57,FALSE
7741,68,11,28,5,94,89,FALSE
7742,126,26,273,5,36,31,FALSE
7743,169,4,152,17,49,32,FALSE
7744,111,11,214,18,100,82,FALSE
7745,159,24,140,11,53,42,FALSE
7746,92,13,195,17,26,9,FALSE
7747,129,4,155,19,61,42,FALSE
7748,77,20,170,9,81,72,FALSE
7749,67,1,171,14,38,24,FALSE
7750,78,4,50,7,93,86,FALSE
7751,90,18,71,17,67,50,FALSE
7752,150,16,21,19,99,80,FALSE
7753,68,18,255,2,93,91,FALSE
7754,33,27,145,8,96,88,FALSE
7755,27,18,278,1,28,27,FALSE
7756,139,14,276,15,21,6,FALSE
7757,122,16,176,5,93,88,True
7758,113,15,253,12,40,28,FALSE
7759,74,16,228,16,24,8,FALSE
7760,183,3,149,9,100,91,FALSE
7761,83,10,117,7,87,80,FALSE
7762,121,26,95,15,80,65,FALSE
7763,102,9,199,3,64,61,FALSE
7764,85,1,177,14,39,25,FALSE
7765,21,9,26,11,69,58,FALSE
7766,65,14,187,15,58,43,FALSE
7767,146,7,299,5,97,92,FALSE
7768,67,21,27,10,72,62,FALSE
7769,85,7,236,12,22,10,FALSE
7770,94,25,158,9,49,40,FALSE
7771,188,23,58,8,83,75,FALSE
7772,70,2,150,12,26,14,FALSE
7773,148,23,161,11,80,69,FALSE
7774,40,20,250,20,21,1,FALSE
7775,29,2,121,16,70,54,FALSE
7776,73,24,207,5,45,40,FALSE
7777,81,29,290,19,51,32,FALSE
7778,60,29,80,17,61,44,FALSE
7779,157,19,134,17,91,74,FALSE
7780,50,6,277,2,88,86,FALSE
7781,192,12,235,11,22,11,FALSE
7782,143,20,181,2,97,95,FALSE
7783,84,12,85,3,58,55,FALSE
7784,89,24,100,3,88,85,FALSE
7785,52,7,254,5,67,62,FALSE
7786,38,8,86,12,91,79,FALSE
7787,103,13,243,10,50,40,FALSE
7788,191,12,165,3,69,66,FALSE
7789,61,21,174,8,70,62,FALSE
7790,109,12,109,2,54,52,True
7791,71,9,223,15,65,50,FALSE
7792,48,4,157,13,37,24,FALSE
7793,22,22,182,1,24,23,FALSE
7794,148,29,202,8,83,75,FALSE
7795,162,29,294,8,28,20,FALSE
7796,67,30,178,15,31,16,FALSE
7797,50,22,141,7,42,35,FALSE
7798,30,9,50,18,68,50,FALSE
7799,58,27,36,3,28,25,FALSE
7800,25,14,169,11,22,11,FALSE
7801,181,18,241,4,35,31,FALSE
7802,73,19,48,13,51,38,FALSE
7803,80,29,267,10,57,47,FALSE
7804,104,27,212,19,28,9,FALSE
7805,49,20,47,19,78,59,FALSE
7806,188,21,299,18,57,39,FALSE
7807,84,8,52,18,20,2,FALSE
7808,154,2,298,15,50,35,FALSE
7809,94,29,71,13,26,13,FALSE
7810,37,26,48,17,78,61,FALSE
7811,117,10,242,16,92,76,FALSE
7812,97,13,291,18,91,73,FALSE
7813,187,28,120,17,49,32,FALSE
7814,22,30,207,18,63,45,FALSE
7815,98,2,271,7,47,40,FALSE
7816,166,23,280,19,64,45,FALSE
7817,20,13,57,5,87,82,FALSE
7818,39,10,20,4,77,73,FALSE
7819,58,29,286,14,100,86,FALSE
7820,152,4,286,7,22,15,FALSE
7821,69,18,219,8,27,19,FALSE
7822,102,4,150,18,39,21,FALSE
7823,130,27,280,15,32,17,FALSE
7824,53,7,195,15,66,51,FALSE
7825,184,14,85,13,55,42,FALSE
7826,31,9,156,13,23,10,FALSE
7827,179,27,109,20,51,31,FALSE
7828,43,23,69,19,88,69,FALSE
7829,177,25,117,18,68,50,True
7830,177,11,123,8,60,52,FALSE
7831,137,24,270,19,38,19,FALSE
7832,127,18,71,7,69,62,FALSE
7833,48,28,174,13,92,79,FALSE
7834,41,2,215,3,88,85,FALSE
7835,118,10,146,9,67,58,FALSE
7836,99,10,86,2,91,89,FALSE
7837,156,5,257,8,70,62,FALSE
7838,166,23,197,6,98,92,FALSE
7839,108,3,294,17,65,48,FALSE
7840,64,17,177,16,66,50,FALSE
7841,191,19,122,1,89,88,FALSE
7842,136,14,121,6,34,28,FALSE
7843,142,24,169,20,27,7,FALSE
7844,40,2,146,6,58,52,FALSE
7845,176,21,297,8,21,13,FALSE
7846,130,13,31,16,78,62,FALSE
7847,143,2,228,18,72,54,FALSE
7848,198,28,241,5,75,70,FALSE
7849,86,5,159,18,23,5,FALSE
7850,200,29,173,10,92,82,FALSE
7851,120,23,31,14,80,66,FALSE
7852,65,27,212,7,32,25,FALSE
7853,180,28,135,3,63,60,FALSE
7854,39,25,52,11,53,42,FALSE
7855,103,25,154,12,98,86,FALSE
7856,32,12,154,15,76,61,FALSE
7857,80,24,167,12,39,27,FALSE
7858,83,16,263,20,64,44,FALSE
7859,66,21,207,14,98,84,FALSE
7860,157,6,262,12,98,86,FALSE
7861,41,16,34,5,77,72,FALSE
7862,175,10,194,2,53,51,FALSE
7863,71,7,128,17,35,18,FALSE
7864,30,12,276,7,94,87,FALSE
7865,32,23,162,5,73,68,FALSE
7866,159,25,100,6,37,31,FALSE
7867,178,8,121,20,47,27,FALSE
7868,185,10,86,18,98,80,FALSE
7869,60,13,189,9,34,25,FALSE
7870,159,29,90,9,28,19,FALSE
7871,59,25,37,9,94,85,FALSE
7872,126,18,78,19,68,49,FALSE
7873,143,20,27,20,83,63,FALSE
7874,59,21,271,1,49,48,FALSE
7875,174,24,212,7,92,85,FALSE
7876,127,17,148,14,30,16,FALSE
7877,26,26,134,16,61,45,FALSE
7878,94,10,126,19,59,40,FALSE
7879,100,24,32,15,36,21,FALSE
7880,197,26,147,3,93,90,FALSE
7881,116,17,199,16,40,24,FALSE
7882,60,26,80,17,53,36,FALSE
7883,93,25,253,3,84,81,FALSE
7884,171,8,295,20,87,67,FALSE
7885,156,10,173,4,37,33,FALSE
7886,67,22,65,10,21,11,FALSE
7887,151,8,154,4,92,88,FALSE
7888,193,19,238,15,82,67,FALSE
7889,104,30,33,3,40,37,FALSE
7890,59,3,291,3,48,45,FALSE
7891,108,8,297,1,50,49,FALSE
7892,122,25,134,1,59,58,FALSE
7893,74,21,23,15,60,45,FALSE
7894,162,2,154,2,86,84,FALSE
7895,155,25,59,13,73,60,FALSE
7896,189,8,219,14,57,43,FALSE
7897,51,2,193,4,50,46,FALSE
7898,197,30,119,1,68,67,FALSE
7899,166,15,277,19,82,63,FALSE
7900,133,27,229,14,91,77,FALSE
7901,117,21,90,6,27,21,FALSE
7902,30,2,139,11,35,24,FALSE
7903,112,8,121,4,49,45,FALSE
7904,132,9,120,10,40,30,FALSE
7905,49,7,26,15,30,15,FALSE
7906,123,7,100,19,30,11,FALSE
7907,153,1,268,14,70,56,FALSE
7908,104,22,217,10,51,41,FALSE
7909,148,24,145,17,98,81,FALSE
7910,68,6,125,15,80,65,FALSE
7911,72,25,185,1,98,97,FALSE
7912,186,5,79,16,97,81,FALSE
7913,54,25,60,9,56,47,FALSE
7914,146,11,40,10,48,38,FALSE
7915,58,17,129,1,57,56,FALSE
7916,34,12,161,18,40,22,FALSE
7917,80,30,117,15,25,10,FALSE
7918,95,30,253,19,73,54,FALSE
7919,166,5,200,1,37,36,FALSE
7920,93,16,192,11,21,10,FALSE
7921,27,18,161,19,90,71,FALSE
7922,106,28,172,3,57,54,FALSE
7923,191,9,94,2,85,83,FALSE
7924,39,26,259,6,44,38,FALSE
7925,64,3,158,16,29,13,FALSE
7926,198,10,173,4,26,22,FALSE
7927,134,9,276,10,76,66,FALSE
7928,164,6,78,16,53,37,FALSE
7929,36,24,268,19,36,17,FALSE
7930,187,16,201,17,21,4,FALSE
7931,119,24,44,18,40,22,FALSE
7932,43,26,20,13,25,12,FALSE
7933,153,16,59,9,43,34,FALSE
7934,91,28,215,20,44,24,FALSE
7935,194,20,29,3,35,32,FALSE
7936,62,27,278,6,68,62,FALSE
7937,24,28,273,2,100,98,FALSE
7938,150,18,271,6,34,28,FALSE
7939,86,6,31,10,84,74,FALSE
7940,139,11,47,8,21,13,FALSE
7941,175,20,97,8,38,30,FALSE
7942,114,3,27,12,58,46,FALSE
7943,75,29,237,11,42,31,FALSE
7944,70,15,93,10,38,28,FALSE
7945,122,13,198,14,99,85,FALSE
7946,32,22,106,10,81,71,FALSE
7947,42,8,194,10,42,32,FALSE
7948,65,10,75,10,55,45,FALSE
7949,73,15,148,12,71,59,FALSE
7950,137,22,99,13,27,14,FALSE
7951,142,28,73,13,71,58,FALSE
7952,188,2,20,15,53,38,FALSE
7953,58,30,211,11,49,38,True
7954,139,9,205,13,20,7,FALSE
7955,153,4,246,17,97,80,FALSE
7956,159,19,209,2,33,31,FALSE
7957,115,18,143,12,72,60,FALSE
7958,114,21,112,12,37,25,FALSE
7959,90,8,110,9,62,53,FALSE
7960,45,17,169,20,79,59,FALSE
7961,62,26,62,14,71,57,FALSE
7962,32,30,80,13,88,75,FALSE
7963,166,28,195,4,29,25,FALSE
7964,169,3,281,11,29,18,FALSE
7965,34,10,240,5,58,53,FALSE
7966,108,3,242,17,44,27,FALSE
7967,112,4,276,3,45,42,FALSE
7968,118,7,146,20,41,21,FALSE
7969,107,25,157,16,39,23,FALSE
7970,45,5,83,19,96,77,FALSE
7971,153,14,88,9,64,55,FALSE
7972,163,3,175,17,63,46,FALSE
7973,28,12,272,7,29,22,FALSE
7974,168,25,57,9,43,34,FALSE
7975,127,25,284,17,39,22,FALSE
7976,87,28,68,4,45,41,FALSE
7977,155,22,69,10,47,37,FALSE
7978,46,12,275,3,83,80,FALSE
7979,96,25,290,17,50,33,FALSE
7980,194,2,131,7,32,25,FALSE
7981,74,29,86,12,36,24,FALSE
7982,150,14,141,20,98,78,FALSE
7983,59,10,22,4,61,57,FALSE
7984,174,29,199,19,72,53,FALSE
7985,150,4,208,12,59,47,FALSE
7986,160,4,205,9,77,68,FALSE
7987,191,20,239,8,31,23,FALSE
7988,164,29,84,16,85,69,FALSE
7989,23,18,190,7,25,18,FALSE
7990,133,18,121,17,24,7,FALSE
7991,101,9,250,20,65,45,FALSE
7992,119,2,128,13,53,40,FALSE
7993,158,4,54,5,93,88,FALSE
7994,66,24,220,6,70,64,FALSE
7995,169,4,138,7,69,62,FALSE
7996,69,23,265,14,37,23,FALSE
7997,87,4,241,20,87,67,FALSE
7998,158,24,42,16,49,33,FALSE
7999,85,24,96,3,31,28,True
8000,83,18,173,4,28,24,FALSE
8001,45,30,231,18,74,56,FALSE
8002,46,17,168,8,70,62,FALSE
8003,137,30,288,15,60,45,FALSE
8004,158,22,29,16,100,84,FALSE
8005,135,17,277,18,27,9,FALSE
8006,49,1,34,5,24,19,FALSE
8007,22,22,286,8,52,44,FALSE
8008,45,15,192,1,21,20,FALSE
8009,70,13,283,13,30,17,FALSE
8010,134,27,185,2,26,24,True
8011,46,20,135,20,97,77,True
8012,36,5,80,15,95,80,FALSE
8013,196,16,116,20,34,14,FALSE
8014,107,15,24,11,87,76,FALSE
8015,156,12,28,17,42,25,FALSE
8016,89,25,286,2,54,52,FALSE
8017,69,17,114,19,37,18,FALSE
8018,84,13,136,6,66,60,FALSE
8019,41,17,33,16,77,61,FALSE
8020,107,4,141,17,46,29,FALSE
8021,141,21,285,14,58,44,FALSE
8022,90,21,185,2,62,60,FALSE
8023,131,17,270,18,76,58,FALSE
8024,32,24,129,12,27,15,FALSE
8025,165,23,204,1,65,64,FALSE
8026,26,5,286,6,98,92,FALSE
8027,144,15,56,3,30,27,FALSE
8028,147,2,192,1,87,86,FALSE
8029,130,13,37,18,31,13,FALSE
8030,88,6,91,17,61,44,FALSE
8031,52,20,262,18,67,49,FALSE
8032,170,22,165,4,100,96,FALSE
8033,198,2,272,19,58,39,FALSE
8034,117,5,203,3,58,55,FALSE
8035,166,26,140,7,73,66,FALSE
8036,136,15,268,13,96,83,FALSE
8037,56,23,169,19,100,81,FALSE
8038,58,28,225,20,94,74,FALSE
8039,56,14,24,3,72,69,FALSE
8040,46,1,108,10,58,48,FALSE
8041,193,24,50,2,46,44,FALSE
8042,35,15,283,10,48,38,FALSE
8043,27,24,228,5,36,31,FALSE
8044,192,10,63,10,52,42,FALSE
8045,45,23,171,13,78,65,FALSE
8046,102,26,281,10,56,46,FALSE
8047,184,26,269,14,36,22,FALSE
8048,183,1,114,8,90,82,FALSE
8049,56,23,34,3,89,86,FALSE
8050,149,5,239,19,82,63,FALSE
8051,194,24,69,18,74,56,FALSE
8052,141,24,213,10,88,78,FALSE
8053,128,18,81,5,65,60,FALSE
8054,146,21,24,10,42,32,FALSE
8055,142,6,162,4,88,84,FALSE
8056,171,26,211,7,80,73,FALSE
8057,178,27,107,9,49,40,FALSE
8058,70,29,205,10,95,85,FALSE
8059,170,26,25,19,71,52,FALSE
8060,177,28,187,15,73,58,FALSE
8061,169,19,87,18,99,81,FALSE
8062,100,22,104,18,68,50,FALSE
8063,118,18,69,18,62,44,FALSE
8064,108,30,95,15,20,5,FALSE
8065,140,7,217,15,91,76,FALSE
8066,117,5,65,12,53,41,FALSE
8067,52,2,129,7,77,70,True
8068,153,26,124,13,83,70,FALSE
8069,59,4,245,3,40,37,FALSE
8070,175,22,288,9,61,52,FALSE
8071,169,22,245,1,49,48,FALSE
8072,170,9,96,5,64,59,FALSE
8073,195,22,33,7,80,73,FALSE
8074,44,16,262,14,45,31,FALSE
8075,143,12,300,18,41,23,FALSE
8076,149,20,294,1,91,90,FALSE
8077,78,20,235,12,78,66,FALSE
8078,151,12,243,15,43,28,FALSE
8079,136,22,244,13,51,38,FALSE
8080,128,13,229,3,44,41,FALSE
8081,84,19,205,7,44,37,FALSE
8082,108,29,121,11,90,79,FALSE
8083,83,8,237,13,64,51,FALSE
8084,108,12,43,13,50,37,True
8085,85,12,273,13,40,27,FALSE
8086,92,30,185,19,62,43,FALSE
8087,72,10,257,17,79,62,FALSE
8088,198,1,229,2,87,85,FALSE
8089,133,10,51,3,51,48,FALSE
8090,199,12,183,5,52,47,FALSE
8091,170,25,47,1,47,46,FALSE
8092,24,12,142,16,88,72,FALSE
8093,57,14,131,17,40,23,FALSE
8094,121,26,210,3,56,53,FALSE
8095,136,14,288,10,44,34,FALSE
8096,87,3,149,7,78,71,FALSE
8097,21,7,58,2,26,24,True
8098,183,8,212,14,80,66,FALSE
8099,124,1,287,1,64,63,FALSE
8100,196,11,162,6,33,27,FALSE
8101,194,8,59,9,26,17,FALSE
8102,26,4,261,17,51,34,FALSE
8103,34,20,226,6,90,84,FALSE
8104,29,9,83,14,66,52,FALSE
8105,52,10,221,3,85,82,FALSE
8106,190,22,87,16,79,63,FALSE
8107,187,9,88,9,70,61,FALSE
8108,31,15,256,12,37,25,FALSE
8109,105,25,149,20,86,66,FALSE
8110,33,28,238,20,48,28,FALSE
8111,127,2,225,17,95,78,FALSE
8112,61,18,136,20,38,18,FALSE
8113,63,6,219,20,68,48,FALSE
8114,97,18,150,20,40,20,FALSE
8115,110,29,25,8,62,54,FALSE
8116,76,20,248,16,96,80,FALSE
8117,112,28,103,10,80,70,FALSE
8118,159,26,112,1,30,29,FALSE
8119,43,6,85,16,94,78,FALSE
8120,161,20,161,16,61,45,FALSE
8121,164,24,189,7,50,43,FALSE
8122,97,27,220,18,92,74,FALSE
8123,106,2,152,12,71,59,FALSE
8124,67,19,208,19,54,35,FALSE
8125,106,18,293,3,100,97,FALSE
8126,114,1,242,16,38,22,FALSE
8127,55,17,295,4,72,68,FALSE
8128,110,18,276,3,88,85,FALSE
8129,163,30,73,20,56,36,FALSE
8130,85,18,166,7,47,40,FALSE
8131,114,30,250,17,21,4,FALSE
8132,110,24,46,3,89,86,FALSE
8133,150,5,42,1,34,33,FALSE
8134,158,27,217,5,82,77,FALSE
8135,99,13,190,6,24,18,FALSE
8136,168,26,126,17,37,20,FALSE
8137,152,12,107,4,60,56,FALSE
8138,189,28,256,12,90,78,FALSE
8139,116,1,169,3,75,72,FALSE
8140,42,14,205,1,83,82,FALSE
8141,195,22,52,20,93,73,FALSE
8142,78,30,212,20,33,13,FALSE
8143,132,2,240,18,56,38,True
8144,64,7,276,10,60,50,True
8145,94,24,278,5,81,76,FALSE
8146,90,9,117,20,83,63,FALSE
8147,109,1,154,14,86,72,FALSE
8148,23,12,264,14,20,6,FALSE
8149,96,13,275,17,72,55,FALSE
8150,48,29,224,7,94,87,FALSE
8151,61,16,124,9,28,19,FALSE
8152,199,29,208,5,38,33,FALSE
8153,92,3,54,6,50,44,FALSE
8154,94,19,270,3,63,60,FALSE
8155,200,23,289,9,46,37,FALSE
8156,28,27,228,19,100,81,FALSE
8157,108,29,292,2,48,46,FALSE
8158,81,25,209,5,29,24,FALSE
8159,139,10,41,12,81,69,FALSE
8160,124,4,95,4,23,19,FALSE
8161,161,3,297,18,94,76,FALSE
8162,62,21,159,13,86,73,FALSE
8163,78,5,211,13,91,78,FALSE
8164,118,23,34,13,75,62,True
8165,57,17,94,2,58,56,FALSE
8166,104,5,265,9,62,53,FALSE
8167,142,15,128,6,42,36,FALSE
8168,80,13,117,17,71,54,FALSE
8169,179,23,75,13,71,58,FALSE
8170,155,28,160,20,23,3,FALSE
8171,40,1,65,7,60,53,FALSE
8172,136,15,222,8,93,85,FALSE
8173,174,9,48,5,77,72,FALSE
8174,196,18,96,10,25,15,FALSE
8175,136,14,252,5,81,76,FALSE
8176,37,22,136,13,93,80,FALSE
8177,44,8,272,9,86,77,FALSE
8178,138,16,212,17,83,66,FALSE
8179,197,10,61,4,47,43,FALSE
8180,102,16,295,17,27,10,FALSE
8181,74,17,45,17,62,45,FALSE
8182,193,25,127,13,44,31,FALSE
8183,139,5,240,2,70,68,FALSE
8184,118,13,111,17,61,44,True
8185,57,27,118,1,66,65,FALSE
8186,192,27,175,3,46,43,FALSE
8187,138,17,290,11,23,12,True
8188,20,3,92,19,78,59,FALSE
8189,34,19,132,5,90,85,FALSE
8190,107,12,284,2,39,37,FALSE
8191,142,10,130,20,67,47,FALSE
8192,188,20,267,13,28,15,FALSE
8193,193,21,56,9,74,65,FALSE
8194,88,30,42,16,39,23,FALSE
8195,102,15,275,7,29,22,FALSE
8196,109,4,289,16,86,70,FALSE
8197,57,18,224,3,40,37,FALSE
8198,119,12,61,2,46,44,FALSE
8199,40,18,109,17,67,50,FALSE
8200,58,6,130,9,98,89,FALSE
8201,34,4,36,7,45,38,FALSE
8202,103,23,170,9,64,55,FALSE
8203,66,28,65,12,97,85,FALSE
8204,90,17,182,2,51,49,FALSE
8205,76,30,229,7,80,73,FALSE
8206,36,7,249,15,78,63,FALSE
8207,143,29,137,9,94,85,FALSE
8208,165,3,89,3,86,83,FALSE
8209,69,13,59,15,29,14,FALSE
8210,96,30,108,19,35,16,FALSE
8211,46,4,232,14,62,48,FALSE
8212,50,14,242,7,73,66,FALSE
8213,115,16,278,12,58,46,FALSE
8214,158,25,268,19,31,12,FALSE
8215,87,30,166,19,43,24,FALSE
8216,93,16,237,6,100,94,FALSE
8217,96,14,44,11,56,45,FALSE
8218,31,29,248,11,71,60,FALSE
8219,106,17,180,6,98,92,FALSE
8220,192,3,156,5,60,55,FALSE
8221,60,16,292,7,22,15,FALSE
8222,87,5,20,1,84,83,FALSE
8223,154,14,278,14,63,49,FALSE
8224,152,26,292,6,40,34,FALSE
8225,36,23,102,1,26,25,FALSE
8226,73,7,222,16,83,67,FALSE
8227,43,9,154,13,54,41,FALSE
8228,75,7,266,2,43,41,FALSE
8229,122,14,123,14,61,47,FALSE
8230,50,4,78,18,34,16,FALSE
8231,40,14,92,6,23,17,FALSE
8232,29,13,264,4,94,90,FALSE
8233,74,23,110,9,77,68,FALSE
8234,27,29,135,12,80,68,FALSE
8235,194,7,28,13,98,85,FALSE
8236,169,10,60,5,46,41,FALSE
8237,97,21,195,15,52,37,FALSE
8238,91,9,289,2,94,92,FALSE
8239,58,7,280,1,49,48,FALSE
8240,162,7,197,6,35,29,FALSE
8241,98,30,81,4,88,84,FALSE
8242,130,23,80,5,100,95,FALSE
8243,189,5,108,17,59,42,FALSE
8244,92,18,101,20,40,20,FALSE
8245,51,18,108,8,39,31,FALSE
8246,170,8,287,4,80,76,FALSE
8247,80,2,56,1,52,51,FALSE
8248,148,22,192,9,76,67,FALSE
8249,144,22,99,19,28,9,FALSE
8250,175,3,222,16,93,77,FALSE
8251,83,15,282,6,76,70,FALSE
8252,63,3,46,4,52,48,FALSE
8253,84,5,28,17,99,82,FALSE
8254,44,26,157,4,53,49,True
8255,53,12,93,7,40,33,FALSE
8256,97,2,30,13,80,67,FALSE
8257,106,13,41,11,91,80,FALSE
8258,124,14,152,14,92,78,FALSE
8259,48,23,62,4,96,92,FALSE
8260,31,21,132,17,82,65,FALSE
8261,76,16,221,16,59,43,FALSE
8262,78,15,134,7,29,22,FALSE
8263,175,17,88,7,59,52,FALSE
8264,45,30,292,5,79,74,FALSE
8265,133,4,242,9,21,12,FALSE
8266,34,10,207,8,56,48,FALSE
8267,75,12,221,15,34,19,FALSE
8268,27,3,45,4,36,32,FALSE
8269,48,7,62,18,47,29,FALSE
8270,139,16,235,19,70,51,FALSE
8271,147,24,283,15,56,41,FALSE
8272,191,4,230,14,86,72,FALSE
8273,82,13,98,1,91,90,FALSE
8274,180,27,225,2,93,91,FALSE
8275,120,22,283,13,53,40,True
8276,73,4,161,16,93,77,FALSE
8277,171,18,140,18,42,24,FALSE
8278,152,21,250,12,47,35,FALSE
8279,188,26,258,15,20,5,FALSE
8280,52,17,47,18,70,52,FALSE
8281,64,21,114,3,91,88,True
8282,181,25,256,16,79,63,FALSE
8283,67,14,264,11,64,53,True
8284,61,2,64,7,51,44,FALSE
8285,24,18,233,11,69,58,FALSE
8286,127,17,296,10,94,84,FALSE
8287,78,5,203,13,78,65,FALSE
8288,101,3,161,18,81,63,FALSE
8289,193,20,49,16,67,51,FALSE
8290,115,4,258,2,66,64,FALSE
8291,28,23,268,16,43,27,FALSE
8292,175,8,294,14,64,50,FALSE
8293,37,21,289,5,60,55,FALSE
8294,50,13,239,11,31,20,FALSE
8295,80,29,113,19,48,29,FALSE
8296,111,10,203,5,49,44,FALSE
8297,37,28,186,5,78,73,FALSE
8298,157,22,43,5,65,60,FALSE
8299,78,25,267,11,72,61,FALSE
8300,182,1,148,8,36,28,FALSE
8301,125,29,129,7,37,30,FALSE
8302,78,30,36,14,34,20,FALSE
8303,99,16,275,11,31,20,FALSE
8304,197,18,300,18,83,65,FALSE
8305,117,13,234,19,84,65,FALSE
8306,187,30,35,4,47,43,FALSE
8307,46,10,260,6,33,27,FALSE
8308,95,2,142,13,78,65,FALSE
8309,141,3,97,20,46,26,FALSE
8310,78,23,269,1,62,61,FALSE
8311,122,7,41,2,58,56,FALSE
8312,148,8,220,9,60,51,FALSE
8313,96,30,198,11,41,30,FALSE
8314,157,15,26,18,20,2,FALSE
8315,173,17,225,8,93,85,FALSE
8316,46,24,130,19,43,24,FALSE
8317,149,20,193,15,81,66,FALSE
8318,113,7,284,16,28,12,FALSE
8319,187,9,85,5,71,66,FALSE
8320,49,23,194,3,60,57,FALSE
8321,58,5,124,1,34,33,FALSE
8322,33,9,276,15,94,79,FALSE
8323,81,1,168,19,85,66,FALSE
8324,178,5,146,5,84,79,FALSE
8325,183,27,65,14,27,13,FALSE
8326,117,26,104,2,57,55,FALSE
8327,126,23,212,19,90,71,FALSE
8328,50,11,269,9,86,77,FALSE
8329,155,7,107,15,22,7,FALSE
8330,27,14,45,10,92,82,FALSE
8331,55,10,117,13,20,7,FALSE
8332,105,23,165,7,84,77,FALSE
8333,91,16,52,10,57,47,FALSE
8334,85,1,296,10,95,85,FALSE
8335,127,5,31,5,21,16,FALSE
8336,196,6,168,7,38,31,FALSE
8337,59,7,123,20,36,16,FALSE
8338,193,10,292,2,64,62,FALSE
8339,167,8,234,13,34,21,FALSE
8340,98,19,86,18,88,70,FALSE
8341,143,12,191,10,22,12,FALSE
8342,182,23,185,17,39,22,FALSE
8343,122,28,39,1,41,40,FALSE
8344,75,10,27,14,89,75,FALSE
8345,80,22,108,20,94,74,FALSE
8346,188,3,147,14,62,48,FALSE
8347,53,2,168,5,96,91,FALSE
8348,35,28,208,14,95,81,FALSE
8349,200,14,28,4,83,79,FALSE
8350,41,10,274,8,20,12,FALSE
8351,184,28,178,18,98,80,FALSE
8352,31,5,198,6,61,55,FALSE
8353,66,15,256,4,21,17,FALSE
8354,190,13,203,11,95,84,FALSE
8355,61,15,229,18,24,6,FALSE
8356,162,5,270,7,29,22,FALSE
8357,186,29,241,5,43,38,FALSE
8358,165,6,133,14,98,84,FALSE
8359,63,17,273,20,59,39,FALSE
8360,136,28,51,3,97,94,FALSE
8361,21,27,135,6,78,72,FALSE
8362,50,13,146,5,47,42,FALSE
8363,140,28,269,18,81,63,FALSE
8364,149,1,277,2,67,65,FALSE
8365,131,7,59,8,63,55,FALSE
8366,93,15,257,11,93,82,FALSE
8367,120,3,144,6,55,49,FALSE
8368,54,10,23,15,43,28,FALSE
8369,94,16,101,11,43,32,FALSE
8370,116,28,250,11,25,14,FALSE
8371,165,21,114,9,68,59,FALSE
8372,45,22,201,15,62,47,True
8373,75,2,33,11,96,85,FALSE
8374,135,2,171,13,80,67,FALSE
8375,71,29,277,3,99,96,FALSE
8376,55,19,236,4,44,40,FALSE
8377,172,18,113,8,33,25,FALSE
8378,170,5,286,15,72,57,FALSE
8379,170,17,97,7,70,63,FALSE
8380,79,8,229,12,72,60,FALSE
8381,176,7,112,14,45,31,FALSE
8382,163,28,291,17,38,21,FALSE
8383,68,7,132,16,91,75,FALSE
8384,59,19,65,12,47,35,FALSE
8385,61,15,105,7,23,16,FALSE
8386,23,2,182,12,72,60,FALSE
8387,92,25,70,6,66,60,FALSE
8388,78,22,198,19,41,22,FALSE
8389,158,18,151,4,39,35,FALSE
8390,180,1,228,12,95,83,FALSE
8391,63,5,189,14,62,48,FALSE
8392,149,12,284,7,43,36,FALSE
8393,59,15,269,16,20,4,FALSE
8394,84,29,68,6,41,35,FALSE
8395,140,16,69,16,84,68,FALSE
8396,85,22,28,12,45,33,FALSE
8397,134,5,263,16,41,25,FALSE
8398,42,18,70,5,95,90,FALSE
8399,105,12,168,17,26,9,FALSE
8400,55,21,213,5,50,45,FALSE
8401,86,15,210,8,66,58,FALSE
8402,120,6,229,8,56,48,FALSE
8403,20,27,31,20,69,49,FALSE
8404,142,22,211,14,64,50,FALSE
8405,53,16,152,13,81,68,FALSE
8406,75,11,280,15,25,10,FALSE
8407,112,29,224,3,70,67,FALSE
8408,61,14,73,18,24,6,FALSE
8409,154,5,220,18,58,40,FALSE
8410,58,8,158,19,47,28,FALSE
8411,36,21,194,10,82,72,FALSE
8412,176,17,95,1,98,97,FALSE
8413,87,3,288,16,41,25,FALSE
8414,45,21,141,18,67,49,FALSE
8415,66,3,219,4,80,76,FALSE
8416,20,18,265,20,49,29,FALSE
8417,92,29,147,14,34,20,FALSE
8418,28,3,182,15,45,30,FALSE
8419,42,13,270,19,94,75,FALSE
8420,44,15,190,19,38,19,FALSE
8421,178,23,294,2,100,98,FALSE
8422,130,7,73,8,99,91,FALSE
8423,177,19,91,5,25,20,FALSE
8424,101,11,61,14,37,23,FALSE
8425,112,3,77,13,88,75,FALSE
8426,157,19,209,9,22,13,FALSE
8427,68,10,33,20,43,23,FALSE
8428,40,1,185,14,40,26,FALSE
8429,88,29,55,8,58,50,FALSE
8430,172,12,40,20,90,70,FALSE
8431,36,9,200,19,71,52,FALSE
8432,44,26,196,11,67,56,FALSE
8433,55,2,124,9,24,15,FALSE
8434,121,15,65,12,28,16,FALSE
8435,138,18,77,6,33,27,FALSE
8436,200,19,178,16,87,71,FALSE
8437,63,6,195,11,75,64,FALSE
8438,49,8,61,7,59,52,FALSE
8439,33,24,48,8,32,24,FALSE
8440,109,1,196,9,82,73,FALSE
8441,67,16,55,19,52,33,FALSE
8442,147,11,34,10,51,41,FALSE
8443,125,23,216,13,70,57,FALSE
8444,57,5,27,11,65,54,FALSE
8445,108,18,270,14,30,16,True
8446,51,15,247,17,27,10,FALSE
8447,178,6,288,13,63,50,FALSE
8448,20,29,124,5,91,86,FALSE
8449,100,16,94,14,22,8,FALSE
8450,110,27,29,3,27,24,FALSE
8451,131,13,30,20,88,68,FALSE
8452,186,24,265,16,49,33,FALSE
8453,59,7,163,18,70,52,FALSE
8454,59,6,57,2,43,41,FALSE
8455,198,15,95,20,31,11,FALSE
8456,100,27,260,10,51,41,FALSE
8457,177,15,137,11,55,44,FALSE
8458,148,16,80,16,100,84,FALSE
8459,167,1,292,4,77,73,FALSE
8460,30,3,178,3,82,79,FALSE
8461,177,18,84,14,94,80,FALSE
8462,94,4,229,4,29,25,FALSE
8463,165,22,295,1,81,80,FALSE
8464,83,5,94,11,63,52,FALSE
8465,159,11,265,6,54,48,FALSE
8466,66,7,159,14,66,52,FALSE
8467,81,27,102,20,80,60,FALSE
8468,131,7,275,19,51,32,FALSE
8469,192,12,26,2,38,36,FALSE
8470,46,7,214,9,56,47,FALSE
8471,156,11,254,18,42,24,FALSE
8472,62,8,123,20,68,48,FALSE
8473,152,4,199,3,78,75,FALSE
8474,143,20,186,19,96,77,FALSE
8475,198,27,92,3,60,57,FALSE
8476,97,9,144,3,54,51,FALSE
8477,56,2,119,7,57,50,FALSE
8478,174,27,298,2,23,21,FALSE
8479,110,3,187,12,55,43,FALSE
8480,65,19,123,14,61,47,FALSE
8481,196,26,180,8,82,74,FALSE
8482,154,3,64,9,81,72,FALSE
8483,130,2,239,19,91,72,FALSE
8484,157,25,150,12,25,13,FALSE
8485,54,10,70,12,65,53,FALSE
8486,59,9,286,14,27,13,FALSE
8487,119,14,109,12,30,18,FALSE
8488,85,23,29,8,58,50,FALSE
8489,105,22,193,13,95,82,True
8490,47,17,174,15,62,47,FALSE
8491,84,23,246,7,34,27,FALSE
8492,78,17,94,18,29,11,FALSE
8493,186,18,101,8,53,45,FALSE
8494,77,12,124,3,56,53,FALSE
8495,197,30,220,1,48,47,FALSE
8496,51,29,69,13,39,26,True
8497,178,19,175,5,73,68,FALSE
8498,71,29,65,19,94,75,FALSE
8499,52,3,152,18,67,49,FALSE
8500,126,23,66,17,51,34,FALSE
8501,188,30,38,7,32,25,FALSE
8502,82,24,96,15,73,58,FALSE
8503,85,27,267,5,57,52,FALSE
8504,194,22,226,10,50,40,FALSE
8505,122,24,235,13,76,63,FALSE
8506,82,22,130,13,37,24,FALSE
8507,41,8,24,12,75,63,FALSE
8508,101,12,109,13,48,35,FALSE
8509,182,7,229,3,76,73,FALSE
8510,166,12,217,17,54,37,FALSE
8511,180,20,263,7,71,64,FALSE
8512,138,6,37,2,81,79,FALSE
8513,72,28,276,18,51,33,FALSE
8514,100,13,196,12,87,75,FALSE
8515,64,9,159,13,24,11,FALSE
8516,152,17,134,3,51,48,FALSE
8517,166,4,236,17,34,17,FALSE
8518,96,20,242,9,49,40,FALSE
8519,82,27,280,18,54,36,True
8520,142,1,72,17,98,81,FALSE
8521,68,24,180,20,54,34,True
8522,88,4,262,15,55,40,FALSE
8523,71,20,238,20,99,79,FALSE
8524,22,20,225,13,65,52,FALSE
8525,46,9,242,18,41,23,FALSE
8526,34,22,64,12,20,8,FALSE
8527,119,30,133,17,97,80,FALSE
8528,23,28,49,10,53,43,FALSE
8529,127,3,64,12,86,74,FALSE
8530,63,30,245,14,54,40,FALSE
8531,80,1,135,15,20,5,FALSE
8532,151,20,100,6,65,59,FALSE
8533,148,30,139,19,69,50,FALSE
8534,134,21,85,17,47,30,FALSE
8535,52,8,173,1,40,39,FALSE
8536,177,21,135,12,45,33,FALSE
8537,102,5,233,15,85,70,FALSE
8538,34,17,181,8,62,54,FALSE
8539,54,21,95,17,75,58,FALSE
8540,126,18,254,10,71,61,FALSE
8541,196,14,255,10,29,19,FALSE
8542,83,10,78,1,67,66,FALSE
8543,78,28,246,5,60,55,FALSE
8544,148,2,248,12,92,80,FALSE
8545,95,26,204,10,22,12,FALSE
8546,59,21,136,10,87,77,FALSE
8547,44,21,66,13,91,78,FALSE
8548,158,13,38,14,33,19,FALSE
8549,43,17,229,3,66,63,FALSE
8550,69,6,187,17,84,67,FALSE
8551,26,29,107,16,47,31,FALSE
8552,145,28,114,19,53,34,FALSE
8553,165,19,201,6,36,30,FALSE
8554,199,3,278,15,67,52,FALSE
8555,67,12,226,17,55,38,FALSE
8556,85,17,117,16,70,54,FALSE
8557,53,18,134,7,86,79,FALSE
8558,176,12,205,8,66,58,FALSE
8559,159,15,195,2,65,63,FALSE
8560,145,21,90,4,93,89,FALSE
8561,193,11,160,1,27,26,FALSE
8562,196,2,231,18,61,43,FALSE
8563,150,15,113,2,24,22,FALSE
8564,40,20,208,19,91,72,FALSE
8565,162,16,207,15,75,60,FALSE
8566,135,23,67,14,96,82,FALSE
8567,118,18,291,7,83,76,FALSE
8568,99,26,35,11,75,64,FALSE
8569,171,6,59,11,63,52,FALSE
8570,21,12,275,1,59,58,FALSE
8571,85,14,236,4,72,68,FALSE
8572,85,23,243,7,98,91,FALSE
8573,145,27,80,13,33,20,FALSE
8574,147,14,92,16,30,14,True
8575,34,26,164,20,90,70,FALSE
8576,100,18,30,6,24,18,FALSE
8577,87,21,108,10,79,69,FALSE
8578,117,7,275,13,90,77,FALSE
8579,152,14,39,14,72,58,FALSE
8580,157,23,211,10,37,27,FALSE
8581,189,6,160,20,77,57,FALSE
8582,88,24,117,15,20,5,FALSE
8583,85,1,146,12,41,29,FALSE
8584,164,28,84,17,88,71,FALSE
8585,80,7,288,12,38,26,FALSE
8586,42,28,160,11,81,70,FALSE
8587,90,10,190,14,97,83,FALSE
8588,49,18,221,7,83,76,FALSE
8589,56,22,35,5,58,53,FALSE
8590,81,19,125,7,30,23,FALSE
8591,82,23,268,9,61,52,FALSE
8592,20,24,240,15,58,43,FALSE
8593,170,30,147,8,28,20,FALSE
8594,42,7,241,17,96,79,FALSE
8595,195,30,109,7,51,44,FALSE
8596,162,1,120,2,50,48,FALSE
8597,192,30,61,14,25,11,FALSE
8598,185,20,251,5,91,86,FALSE
8599,154,7,245,14,65,51,FALSE
8600,84,25,55,13,92,79,FALSE
8601,129,3,154,2,61,59,True
8602,177,8,259,1,67,66,FALSE
8603,111,5,255,18,24,6,FALSE
8604,112,16,56,17,80,63,FALSE
8605,74,27,292,4,98,94,FALSE
8606,113,21,101,18,28,10,FALSE
8607,40,19,210,9,74,65,FALSE
8608,133,22,121,13,69,56,FALSE
8609,140,16,67,16,49,33,FALSE
8610,177,13,94,2,59,57,FALSE
8611,184,27,224,14,95,81,FALSE
8612,184,26,71,2,89,87,FALSE
8613,138,26,264,9,79,70,FALSE
8614,82,28,182,11,20,9,FALSE
8615,145,27,138,8,29,21,FALSE
8616,200,2,247,19,52,33,FALSE
8617,42,7,243,14,91,77,FALSE
8618,180,3,38,11,82,71,FALSE
8619,126,8,70,10,46,36,FALSE
8620,99,7,239,5,32,27,FALSE
8621,132,12,86,9,82,73,FALSE
8622,168,20,173,6,67,61,FALSE
8623,151,10,229,9,84,75,FALSE
8624,116,23,198,1,79,78,FALSE
8625,36,2,66,13,57,44,True
8626,176,7,48,7,40,33,FALSE
8627,140,23,259,9,51,42,FALSE
8628,158,4,143,1,49,48,FALSE
8629,168,13,52,3,100,97,FALSE
8630,89,2,81,13,77,64,FALSE
8631,47,21,74,4,61,57,FALSE
8632,132,4,293,12,85,73,FALSE
8633,27,12,143,12,90,78,FALSE
8634,37,6,257,6,86,80,FALSE
8635,69,10,218,1,74,73,FALSE
8636,75,21,199,10,53,43,FALSE
8637,93,25,201,3,23,20,FALSE
8638,129,28,267,10,46,36,FALSE
8639,199,3,117,6,81,75,FALSE
8640,55,24,26,6,78,72,FALSE
8641,39,2,50,6,78,72,FALSE
8642,40,21,25,11,71,60,FALSE
8643,170,27,32,10,43,33,FALSE
8644,84,6,93,2,75,73,FALSE
8645,115,25,266,15,64,49,FALSE
8646,168,9,61,19,94,75,FALSE
8647,156,25,297,16,94,78,FALSE
8648,139,13,279,15,41,26,FALSE
8649,27,17,97,7,97,90,FALSE
8650,38,20,207,16,89,73,FALSE
8651,72,13,37,16,46,30,FALSE
8652,82,28,73,1,76,75,FALSE
8653,42,6,185,20,80,60,FALSE
8654,133,18,91,13,90,77,FALSE
8655,138,1,89,10,54,44,FALSE
8656,157,19,164,9,52,43,FALSE
8657,195,13,170,5,65,60,FALSE
8658,191,25,169,16,54,38,FALSE
8659,167,26,196,9,67,58,FALSE
8660,66,10,235,1,80,79,FALSE
8661,134,12,54,18,60,42,FALSE
8662,20,30,34,2,49,47,FALSE
8663,129,11,297,14,44,30,FALSE
8664,195,16,74,11,41,30,FALSE
8665,31,5,39,1,89,88,FALSE
8666,46,12,258,5,85,80,FALSE
8667,85,21,66,7,79,72,FALSE
8668,37,21,296,18,36,18,FALSE
8669,122,5,140,20,53,33,FALSE
8670,193,7,144,2,29,27,FALSE
8671,40,14,286,10,24,14,FALSE
8672,200,11,167,7,42,35,FALSE
8673,163,3,223,18,24,6,FALSE
8674,58,13,282,17,23,6,FALSE
8675,26,28,235,9,46,37,FALSE
8676,200,21,205,5,67,62,FALSE
8677,31,3,230,12,73,61,FALSE
8678,168,28,89,13,98,85,FALSE
8679,135,9,140,16,85,69,FALSE
8680,115,7,105,10,90,80,FALSE
8681,93,14,89,6,91,85,FALSE
8682,69,10,55,4,45,41,FALSE
8683,82,18,280,7,60,53,FALSE
8684,86,15,284,14,55,41,FALSE
8685,179,5,216,13,74,61,FALSE
8686,147,30,226,19,33,14,FALSE
8687,23,12,166,3,40,37,FALSE
8688,86,13,74,7,83,76,FALSE
8689,155,27,284,7,72,65,FALSE
8690,199,21,31,3,87,84,FALSE
8691,125,25,189,6,38,32,FALSE
8692,46,26,266,7,75,68,FALSE
8693,77,21,197,4,86,82,FALSE
8694,150,14,111,11,90,79,FALSE
8695,23,26,67,10,84,74,FALSE
8696,106,9,75,16,89,73,FALSE
8697,139,22,110,20,78,58,FALSE
8698,38,25,61,9,98,89,FALSE
8699,27,3,134,8,49,41,FALSE
8700,37,23,286,1,29,28,FALSE
8701,50,17,182,8,83,75,FALSE
8702,192,14,70,19,33,14,FALSE
8703,40,10,176,6,86,80,FALSE
8704,143,20,173,13,95,82,FALSE
8705,93,16,206,13,74,61,FALSE
8706,35,13,50,12,83,71,FALSE
8707,162,1,57,17,94,77,FALSE
8708,133,17,229,14,20,6,FALSE
8709,145,26,65,4,39,35,FALSE
8710,67,10,206,12,71,59,FALSE
8711,32,17,196,3,29,26,FALSE
8712,199,19,235,13,41,28,FALSE
8713,28,17,152,14,39,25,FALSE
8714,160,17,147,20,44,24,FALSE
8715,48,12,22,17,39,22,FALSE
8716,148,13,81,11,29,18,FALSE
8717,24,22,71,8,90,82,FALSE
8718,111,2,288,16,55,39,FALSE
8719,182,9,220,13,93,80,FALSE
8720,165,5,32,7,59,52,FALSE
8721,134,22,76,16,25,9,FALSE
8722,21,4,150,4,53,49,FALSE
8723,62,10,102,8,35,27,FALSE
8724,150,9,67,17,62,45,FALSE
8725,161,21,274,7,31,24,FALSE
8726,137,12,87,8,26,18,FALSE
8727,72,30,186,3,94,91,FALSE
8728,105,5,41,9,20,11,FALSE
8729,125,17,258,12,84,72,FALSE
8730,113,29,129,14,22,8,FALSE
8731,194,15,58,10,46,36,FALSE
8732,95,21,277,4,25,21,FALSE
8733,121,14,61,11,32,21,FALSE
8734,181,24,98,11,73,62,FALSE
8735,126,20,137,9,46,37,FALSE
8736,193,1,42,6,60,54,FALSE
8737,146,15,85,18,91,73,True
8738,159,15,117,2,22,20,FALSE
8739,142,6,251,16,80,64,FALSE
8740,71,4,108,10,55,45,FALSE
8741,144,14,229,16,57,41,FALSE
8742,167,3,102,2,37,35,FALSE
8743,181,28,130,16,86,70,FALSE
8744,127,7,213,20,86,66,FALSE
8745,137,17,22,13,58,45,FALSE
8746,84,27,162,11,24,13,FALSE
8747,42,6,255,8,32,24,FALSE
8748,197,24,173,14,98,84,FALSE
8749,98,25,21,2,93,91,FALSE
8750,40,26,143,18,39,21,FALSE
8751,179,17,52,15,20,5,FALSE
8752,43,29,243,7,54,47,FALSE
8753,181,15,247,20,94,74,FALSE
8754,48,19,150,3,29,26,FALSE
8755,90,3,113,11,30,19,True
8756,141,1,118,7,89,82,FALSE
8757,105,21,58,2,64,62,FALSE
8758,110,23,111,8,88,80,FALSE
8759,94,2,279,12,70,58,FALSE
8760,139,29,208,11,40,29,FALSE
8761,83,6,33,17,92,75,FALSE
8762,109,27,267,13,83,70,FALSE
8763,55,9,288,18,93,75,FALSE
8764,92,14,198,15,51,36,FALSE
8765,87,23,271,9,60,51,FALSE
8766,151,19,123,6,82,76,FALSE
8767,23,14,220,9,73,64,FALSE
8768,23,22,260,12,64,52,FALSE
8769,76,20,86,2,38,36,FALSE
8770,169,7,228,14,34,20,FALSE
8771,104,30,56,4,21,17,FALSE
8772,174,30,205,3,35,32,FALSE
8773,85,11,259,11,30,19,FALSE
8774,183,19,274,11,53,42,FALSE
8775,173,17,35,11,38,27,FALSE
8776,164,19,220,13,29,16,FALSE
8777,81,23,273,9,92,83,FALSE
8778,167,23,278,4,34,30,FALSE
8779,73,27,85,7,62,55,FALSE
8780,39,4,62,11,85,74,FALSE
8781,141,4,27,20,98,78,FALSE
8782,129,3,115,14,78,64,FALSE
8783,136,8,178,15,72,57,FALSE
8784,36,13,182,1,22,21,FALSE
8785,66,30,135,2,80,78,FALSE
8786,167,1,241,8,68,60,FALSE
8787,109,9,95,2,84,82,FALSE
8788,70,3,53,16,99,83,FALSE
8789,51,19,252,14,39,25,FALSE
8790,69,27,254,15,43,28,FALSE
8791,175,29,262,10,40,30,FALSE
8792,112,6,278,6,83,77,FALSE
8793,93,21,112,3,90,87,FALSE
8794,26,17,53,1,26,25,FALSE
8795,106,28,288,4,30,26,FALSE
8796,39,23,79,7,58,51,FALSE
8797,51,30,158,16,89,73,FALSE
8798,30,30,80,13,35,22,FALSE
8799,196,13,187,7,90,83,FALSE
8800,61,27,294,2,39,37,FALSE
8801,154,4,42,11,84,73,FALSE
8802,199,7,175,18,28,10,FALSE
8803,56,14,123,4,58,54,True
8804,185,18,262,20,55,35,FALSE
8805,108,14,170,9,55,46,FALSE
8806,34,4,60,5,53,48,FALSE
8807,119,19,100,20,86,66,FALSE
8808,20,5,224,12,30,18,FALSE
8809,112,4,38,8,94,86,FALSE
8810,200,6,95,15,46,31,FALSE
8811,66,1,169,11,38,27,FALSE
8812,113,21,180,14,50,36,FALSE
8813,66,27,256,9,60,51,FALSE
8814,140,18,238,14,92,78,FALSE
8815,156,28,41,11,28,17,FALSE
8816,96,12,75,14,80,66,FALSE
8817,126,20,164,11,74,63,FALSE
8818,167,12,224,12,29,17,FALSE
8819,113,26,193,10,81,71,FALSE
8820,193,4,45,1,58,57,FALSE
8821,31,1,136,18,96,78,FALSE
8822,53,3,127,16,55,39,FALSE
8823,59,1,185,14,20,6,FALSE
8824,183,6,150,12,38,26,FALSE
8825,131,6,205,3,66,63,FALSE
8826,133,8,192,18,26,8,FALSE
8827,165,15,188,9,37,28,FALSE
8828,48,25,117,9,84,75,FALSE
8829,75,9,293,18,65,47,FALSE
8830,91,23,208,5,31,26,FALSE
8831,117,25,143,10,38,28,FALSE
8832,37,28,254,20,59,39,FALSE
8833,139,1,53,11,22,11,FALSE
8834,34,9,104,5,81,76,FALSE
8835,116,5,181,10,74,64,FALSE
8836,176,21,124,2,54,52,FALSE
8837,195,21,255,13,28,15,FALSE
8838,115,24,246,8,25,17,FALSE
8839,159,12,77,17,58,41,FALSE
8840,162,5,40,2,73,71,FALSE
8841,186,14,152,11,63,52,FALSE
8842,20,8,157,14,22,8,FALSE
8843,79,12,46,12,79,67,FALSE
8844,115,30,174,19,93,74,FALSE
8845,47,20,253,2,29,27,FALSE
8846,108,22,130,13,35,22,FALSE
8847,154,3,236,10,89,79,FALSE
8848,102,21,206,1,81,80,FALSE
8849,152,30,151,17,70,53,FALSE
8850,198,2,263,19,81,62,FALSE
8851,191,8,65,17,36,19,FALSE
8852,190,25,298,13,32,19,FALSE
8853,20,4,63,13,77,64,FALSE
8854,174,20,253,12,24,12,FALSE
8855,31,27,151,7,82,75,FALSE
8856,22,30,150,19,77,58,FALSE
8857,192,25,121,17,89,72,FALSE
8858,36,15,272,9,79,70,FALSE
8859,49,30,251,12,40,28,True
8860,157,18,258,20,21,1,FALSE
8861,24,3,133,14,85,71,FALSE
8862,134,14,267,14,58,44,FALSE
8863,24,23,125,16,96,80,FALSE
8864,104,28,90,13,40,27,FALSE
8865,92,28,92,14,65,51,FALSE
8866,46,7,54,6,98,92,FALSE
8867,83,15,139,10,58,48,FALSE
8868,69,15,244,2,22,20,FALSE
8869,160,23,94,17,76,59,FALSE
8870,185,14,119,12,46,34,FALSE
8871,186,24,209,6,87,81,True
8872,100,2,23,20,20,0,FALSE
8873,20,27,172,1,27,26,FALSE
8874,134,5,174,1,89,88,FALSE
8875,192,14,26,10,59,49,FALSE
8876,28,15,58,11,92,81,FALSE
8877,107,14,159,5,79,74,FALSE
8878,177,14,73,11,39,28,FALSE
8879,98,8,296,1,81,80,FALSE
8880,183,9,291,11,97,86,FALSE
8881,146,13,215,10,99,89,FALSE
8882,193,19,36,15,88,73,FALSE
8883,24,17,163,19,26,7,FALSE
8884,69,12,45,1,32,31,FALSE
8885,38,12,90,4,80,76,FALSE
8886,154,28,136,18,79,61,FALSE
8887,35,18,26,14,31,17,FALSE
8888,100,5,218,6,32,26,FALSE
8889,102,21,55,15,21,6,FALSE
8890,138,30,259,12,65,53,FALSE
8891,129,14,133,6,31,25,FALSE
8892,200,2,120,8,65,57,FALSE
8893,170,27,258,9,48,39,FALSE
8894,166,6,224,19,27,8,FALSE
8895,183,16,34,4,92,88,FALSE
8896,195,12,270,10,33,23,FALSE
8897,154,2,245,13,52,39,FALSE
8898,180,15,129,13,59,46,FALSE
8899,129,14,133,20,84,64,FALSE
8900,107,21,299,11,59,48,FALSE
8901,38,9,177,5,35,30,FALSE
8902,95,7,205,7,100,93,FALSE
8903,168,9,277,15,20,5,FALSE
8904,153,6,142,11,87,76,FALSE
8905,102,19,249,6,40,34,FALSE
8906,44,5,123,9,81,72,FALSE
8907,84,14,68,13,53,40,FALSE
8908,104,18,42,19,43,24,FALSE
8909,118,5,23,3,100,97,FALSE
8910,127,3,190,19,90,71,FALSE
8911,109,25,211,12,63,51,FALSE
8912,198,25,51,19,36,17,FALSE
8913,29,8,63,3,43,40,FALSE
8914,45,20,202,6,71,65,FALSE
8915,54,17,270,7,62,55,FALSE
8916,29,11,268,18,44,26,FALSE
8917,113,6,87,12,82,70,FALSE
8918,172,15,64,5,38,33,FALSE
8919,106,27,57,11,75,64,FALSE
8920,131,7,283,10,84,74,FALSE
8921,101,6,108,7,52,45,FALSE
8922,77,29,82,9,68,59,FALSE
8923,115,20,181,20,85,65,FALSE
8924,86,27,125,9,34,25,FALSE
8925,42,3,175,6,67,61,FALSE
8926,41,27,170,14,64,50,FALSE
8927,199,15,206,3,86,83,FALSE
8928,149,13,277,4,53,49,FALSE
8929,189,5,173,17,52,35,FALSE
8930,67,10,174,8,43,35,FALSE
8931,92,11,90,17,70,53,True
8932,102,27,112,7,55,48,FALSE
8933,167,2,218,9,87,78,FALSE
8934,31,18,31,15,74,59,True
8935,146,22,115,19,56,37,FALSE
8936,185,15,259,2,51,49,FALSE
8937,35,23,262,1,38,37,FALSE
8938,48,11,293,6,76,70,FALSE
8939,105,19,126,13,81,68,FALSE
8940,175,28,141,9,77,68,True
8941,26,1,33,8,90,82,FALSE
8942,29,28,254,18,52,34,FALSE
8943,66,15,50,4,61,57,FALSE
8944,148,3,128,16,84,68,FALSE
8945,117,29,39,4,49,45,FALSE
8946,29,10,293,15,39,24,FALSE
8947,168,10,78,19,54,35,FALSE
8948,181,19,28,15,89,74,FALSE
8949,109,19,190,5,47,42,FALSE
8950,127,7,155,14,22,8,FALSE
8951,123,2,158,19,63,44,FALSE
8952,93,25,150,14,20,6,FALSE
8953,200,25,158,4,39,35,True
8954,96,19,140,6,76,70,FALSE
8955,52,23,271,18,68,50,FALSE
8956,128,7,154,3,100,97,FALSE
8957,25,10,126,5,84,79,FALSE
8958,40,17,22,8,25,17,FALSE
8959,184,25,82,11,70,59,FALSE
8960,67,25,266,17,88,71,FALSE
8961,193,3,57,11,94,83,FALSE
8962,103,8,88,17,35,18,FALSE
8963,89,27,191,5,39,34,FALSE
8964,182,13,101,14,32,18,FALSE
8965,43,19,69,12,37,25,FALSE
8966,67,16,161,15,99,84,FALSE
8967,99,21,188,16,30,14,FALSE
8968,192,20,180,6,95,89,FALSE
8969,182,22,142,16,43,27,FALSE
8970,192,26,282,4,63,59,FALSE
8971,35,10,286,2,34,32,FALSE
8972,86,24,140,6,24,18,FALSE
8973,119,23,254,4,66,62,FALSE
8974,40,15,134,10,33,23,FALSE
8975,163,24,207,11,64,53,FALSE
8976,104,4,271,13,33,20,FALSE
8977,200,23,272,10,64,54,FALSE
8978,167,9,38,12,88,76,FALSE
8979,56,29,115,9,50,41,FALSE
8980,142,25,167,18,41,23,FALSE
8981,143,26,212,16,71,55,FALSE
8982,33,22,50,6,42,36,FALSE
8983,144,21,111,17,29,12,FALSE
8984,27,22,296,5,45,40,FALSE
8985,130,23,79,14,80,66,FALSE
8986,112,4,191,10,20,10,FALSE
8987,110,11,119,17,21,4,FALSE
8988,144,29,256,5,74,69,FALSE
8989,117,2,161,8,75,67,FALSE
8990,67,8,148,19,66,47,FALSE
8991,157,28,37,2,98,96,FALSE
8992,164,24,266,13,40,27,FALSE
8993,27,10,202,7,77,70,FALSE
8994,199,17,206,12,66,54,FALSE
8995,73,22,296,14,84,70,FALSE
8996,131,2,92,15,27,12,FALSE
8997,113,2,140,3,69,66,FALSE
8998,133,5,94,10,23,13,FALSE
8999,39,2,291,8,96,88,FALSE
9000,38,13,74,12,49,37,FALSE
9001,92,17,271,9,60,51,FALSE
9002,175,6,29,15,30,15,FALSE
9003,68,1,129,18,22,4,FALSE
9004,181,27,192,2,49,47,FALSE
9005,76,14,156,11,78,67,FALSE
9006,66,22,21,5,45,40,FALSE
9007,61,30,41,4,47,43,FALSE
9008,174,5,117,3,95,92,FALSE
9009,112,10,179,6,46,40,FALSE
9010,189,4,205,2,26,24,FALSE
9011,156,13,217,15,79,64,FALSE
9012,115,25,63,10,52,42,FALSE
9013,142,14,234,9,53,44,FALSE
9014,103,22,75,1,79,78,FALSE
9015,75,23,111,8,37,29,FALSE
9016,60,18,209,13,78,65,FALSE
9017,56,3,33,10,66,56,FALSE
9018,92,12,275,4,76,72,FALSE
9019,36,29,227,14,75,61,FALSE
9020,49,27,291,1,91,90,FALSE
9021,175,5,124,6,30,24,FALSE
9022,135,23,80,7,33,26,FALSE
9023,33,20,198,8,33,25,FALSE
9024,127,15,295,16,27,11,FALSE
9025,102,4,150,16,31,15,FALSE
9026,42,3,60,6,62,56,FALSE
9027,173,26,269,20,99,79,FALSE
9028,38,12,183,6,70,64,FALSE
9029,182,3,213,11,61,50,FALSE
9030,27,13,166,17,33,16,FALSE
9031,143,18,267,5,52,47,FALSE
9032,133,4,110,20,32,12,FALSE
9033,56,22,260,7,75,68,FALSE
9034,22,2,67,12,77,65,FALSE
9035,22,2,140,6,95,89,FALSE
9036,20,10,75,6,88,82,FALSE
9037,51,30,179,3,78,75,FALSE
9038,186,20,175,9,85,76,FALSE
9039,74,3,234,8,85,77,FALSE
9040,154,1,38,10,25,15,FALSE
9041,159,29,279,11,26,15,FALSE
9042,85,19,139,3,82,79,FALSE
9043,112,30,27,7,24,17,FALSE
9044,26,14,67,20,92,72,FALSE
9045,171,3,158,1,33,32,FALSE
9046,141,12,224,5,39,34,FALSE
9047,95,5,268,2,41,39,FALSE
9048,115,5,173,19,39,20,FALSE
9049,71,4,271,2,44,42,FALSE
9050,115,15,28,12,98,86,FALSE
9051,123,9,91,12,56,44,FALSE
9052,141,15,214,15,97,82,FALSE
9053,26,30,264,15,36,21,FALSE
9054,193,29,122,15,80,65,FALSE
9055,21,7,163,17,35,18,FALSE
9056,149,5,258,10,39,29,FALSE
9057,110,6,119,1,69,68,FALSE
9058,116,14,30,12,27,15,FALSE
9059,167,17,103,11,27,16,FALSE
9060,94,4,271,17,23,6,FALSE
9061,32,11,281,1,64,63,FALSE
9062,193,4,147,3,87,84,FALSE
9063,32,4,242,9,58,49,FALSE
9064,168,19,165,13,63,50,FALSE
9065,174,2,52,6,76,70,FALSE
9066,76,3,169,13,61,48,FALSE
9067,49,25,79,15,70,55,FALSE
9068,39,28,218,20,38,18,FALSE
9069,171,25,273,13,52,39,True
9070,46,3,167,15,78,63,FALSE
9071,54,4,163,8,91,83,FALSE
9072,134,1,98,7,51,44,FALSE
9073,158,18,158,6,31,25,FALSE
9074,149,15,137,7,89,82,FALSE
9075,168,15,141,14,74,60,FALSE
9076,154,23,79,15,84,69,FALSE
9077,75,15,156,18,71,53,FALSE
9078,78,30,59,19,40,21,FALSE
9079,49,8,173,8,89,81,FALSE
9080,27,27,27,3,74,71,FALSE
9081,104,1,156,10,53,43,FALSE
9082,119,7,22,20,45,25,FALSE
9083,28,7,126,2,93,91,FALSE
9084,156,22,141,19,92,73,FALSE
9085,167,19,239,16,58,42,FALSE
9086,167,6,210,15,96,81,FALSE
9087,162,28,202,10,32,22,FALSE
9088,193,16,203,8,34,26,FALSE
9089,166,22,250,4,39,35,FALSE
9090,55,12,246,7,89,82,FALSE
9091,89,15,105,1,40,39,FALSE
9092,67,26,204,15,91,76,FALSE
9093,86,29,58,4,60,56,FALSE
9094,195,5,154,7,94,87,FALSE
9095,86,24,91,18,86,68,FALSE
9096,68,11,167,7,93,86,FALSE
9097,186,29,244,19,92,73,FALSE
9098,133,4,28,7,75,68,FALSE
9099,121,6,252,16,98,82,FALSE
9100,180,17,250,1,46,45,FALSE
9101,85,17,202,7,94,87,FALSE
9102,101,26,171,1,81,80,FALSE
9103,125,26,117,19,56,37,FALSE
9104,51,18,201,9,48,39,FALSE
9105,137,20,135,8,28,20,FALSE
9106,176,17,256,5,63,58,True
9107,84,9,225,2,70,68,FALSE
9108,179,2,165,16,56,40,FALSE
9109,83,19,82,15,58,43,FALSE
9110,187,19,82,9,73,64,FALSE
9111,148,24,216,15,63,48,FALSE
9112,63,14,243,1,73,72,FALSE
9113,40,18,72,7,48,41,FALSE
9114,51,24,100,19,21,2,FALSE
9115,193,26,296,14,26,12,FALSE
9116,178,5,209,2,63,61,FALSE
9117,155,13,150,15,59,44,FALSE
9118,49,30,248,19,39,20,FALSE
9119,88,20,284,20,83,63,FALSE
9120,30,1,85,3,41,38,FALSE
9121,172,15,217,10,80,70,FALSE
9122,119,7,128,18,83,65,FALSE
9123,155,5,37,1,96,95,FALSE
9124,91,27,295,18,48,30,FALSE
9125,130,10,248,8,73,65,FALSE
9126,127,29,242,10,30,20,FALSE
9127,83,14,88,16,34,18,FALSE
9128,88,17,228,13,59,46,FALSE
9129,78,27,237,15,91,76,FALSE
9130,69,18,288,16,44,28,FALSE
9131,106,6,26,1,48,47,FALSE
9132,188,1,166,9,88,79,FALSE
9133,182,11,193,20,93,73,FALSE
9134,187,26,65,15,24,9,FALSE
9135,197,14,216,2,65,63,FALSE
9136,27,14,28,4,96,92,FALSE
9137,180,17,213,13,51,38,FALSE
9138,142,21,26,18,80,62,FALSE
9139,73,3,289,5,82,77,FALSE
9140,82,21,113,5,73,68,FALSE
9141,180,3,66,13,41,28,FALSE
9142,74,18,91,11,94,83,FALSE
9143,90,29,177,10,92,82,FALSE
9144,43,28,267,5,100,95,FALSE
9145,79,9,30,3,90,87,FALSE
9146,67,29,296,9,89,80,FALSE
9147,32,20,216,10,44,34,FALSE
9148,155,10,227,15,21,6,FALSE
9149,124,20,250,15,64,49,FALSE
9150,35,29,237,12,51,39,FALSE
9151,104,30,285,7,46,39,FALSE
9152,45,26,159,4,56,52,FALSE
9153,142,5,30,19,73,54,True
9154,182,25,243,1,35,34,FALSE
9155,193,9,286,5,79,74,FALSE
9156,49,15,208,5,32,27,FALSE
9157,67,7,224,8,52,44,FALSE
9158,87,12,47,3,80,77,FALSE
9159,63,18,232,4,100,96,FALSE
9160,40,2,278,17,40,23,FALSE
9161,183,1,110,10,61,51,FALSE
9162,153,3,270,9,90,81,FALSE
9163,66,28,79,13,33,20,FALSE
9164,144,30,148,13,62,49,FALSE
9165,140,7,254,18,89,71,FALSE
9166,135,30,21,1,31,30,FALSE
9167,70,23,239,8,96,88,FALSE
9168,198,7,172,20,97,77,FALSE
9169,138,28,202,17,20,3,FALSE
9170,28,17,197,14,86,72,FALSE
9171,170,6,73,17,32,15,FALSE
9172,188,23,193,5,22,17,True
9173,71,28,62,12,73,61,FALSE
9174,66,17,126,9,51,42,FALSE
9175,31,27,118,5,80,75,FALSE
9176,135,23,22,11,30,19,FALSE
9177,50,25,29,18,76,58,FALSE
9178,47,9,146,15,33,18,FALSE
9179,158,5,166,7,60,53,FALSE
9180,173,9,230,9,55,46,FALSE
9181,169,18,149,9,82,73,FALSE
9182,160,2,189,15,25,10,FALSE
9183,130,6,284,6,74,68,FALSE
9184,95,26,36,1,21,20,FALSE
9185,21,1,57,7,83,76,FALSE
9186,30,22,296,10,32,22,FALSE
9187,23,26,300,14,43,29,FALSE
9188,95,9,178,1,59,58,FALSE
9189,178,2,280,10,23,13,FALSE
9190,44,20,201,3,68,65,FALSE
9191,149,4,194,3,51,48,FALSE
9192,24,26,59,12,29,17,FALSE
9193,72,10,28,17,26,9,FALSE
9194,130,15,272,10,88,78,FALSE
9195,60,24,214,19,75,56,FALSE
9196,133,7,176,15,49,34,FALSE
9197,59,14,120,1,85,84,FALSE
9198,60,19,28,13,44,31,FALSE
9199,125,12,89,16,77,61,FALSE
9200,49,24,244,19,60,41,FALSE
9201,110,23,212,9,74,65,FALSE
9202,55,4,69,9,55,46,FALSE
9203,180,1,186,14,70,56,FALSE
9204,164,3,289,2,72,70,True
9205,99,10,21,2,90,88,FALSE
9206,120,9,92,11,92,81,FALSE
9207,160,9,241,11,82,71,FALSE
9208,67,11,69,8,22,14,FALSE
9209,35,15,204,18,49,31,FALSE
9210,66,19,35,20,22,2,FALSE
9211,131,19,211,20,66,46,FALSE
9212,61,20,276,8,92,84,FALSE
9213,142,20,64,1,44,43,True
9214,165,28,114,8,83,75,FALSE
9215,150,29,71,6,71,65,FALSE
9216,43,24,68,8,83,75,FALSE
9217,98,29,283,3,84,81,FALSE
9218,68,13,285,13,21,8,FALSE
9219,66,7,183,6,73,67,FALSE
9220,126,30,36,18,44,26,FALSE
9221,154,16,299,15,91,76,FALSE
9222,128,18,154,18,39,21,FALSE
9223,45,28,189,17,41,24,FALSE
9224,112,14,29,6,45,39,FALSE
9225,190,20,293,9,90,81,FALSE
9226,173,27,279,3,64,61,FALSE
9227,176,24,63,5,28,23,FALSE
9228,136,4,277,5,42,37,FALSE
9229,182,24,119,20,33,13,FALSE
9230,164,28,60,10,25,15,FALSE
9231,67,14,42,9,44,35,FALSE
9232,150,13,148,17,73,56,FALSE
9233,57,30,76,1,23,22,FALSE
9234,50,22,221,11,84,73,FALSE
9235,30,27,221,12,83,71,FALSE
9236,63,20,236,15,96,81,FALSE
9237,26,3,140,18,50,32,FALSE
9238,31,16,286,16,67,51,FALSE
9239,130,7,236,11,38,27,FALSE
9240,188,26,162,12,31,19,FALSE
9241,135,2,208,14,46,32,FALSE
9242,186,28,86,12,84,72,True
9243,42,7,234,11,27,16,FALSE
9244,120,15,298,2,66,64,FALSE
9245,36,4,172,7,89,82,FALSE
9246,125,22,74,4,22,18,FALSE
9247,150,24,137,13,70,57,FALSE
9248,161,26,262,17,51,34,FALSE
9249,197,13,197,20,36,16,FALSE
9250,82,27,37,8,36,28,FALSE
9251,178,11,113,17,79,62,FALSE
9252,28,7,284,9,83,74,FALSE
9253,175,7,172,12,66,54,FALSE
9254,47,3,288,12,55,43,FALSE
9255,37,3,225,3,81,78,FALSE
9256,79,30,87,5,28,23,FALSE
9257,112,10,53,16,89,73,FALSE
9258,54,3,151,16,46,30,FALSE
9259,60,8,137,19,91,72,FALSE
9260,153,10,274,10,93,83,True
9261,131,10,134,10,93,83,FALSE
9262,24,28,20,6,99,93,FALSE
9263,71,12,226,11,82,71,FALSE
9264,129,23,23,6,63,57,FALSE
9265,195,9,261,13,43,30,FALSE
9266,136,10,264,14,27,13,FALSE
9267,182,25,39,3,22,19,FALSE
9268,133,4,223,2,88,86,FALSE
9269,46,25,57,9,93,84,FALSE
9270,57,4,33,20,24,4,FALSE
9271,169,11,115,7,21,14,FALSE
9272,49,26,113,10,80,70,FALSE
9273,104,30,62,7,46,39,FALSE
9274,107,11,243,9,88,79,FALSE
9275,162,8,36,7,42,35,FALSE
9276,90,26,36,2,44,42,FALSE
9277,46,17,32,6,63,57,FALSE
9278,46,29,33,20,73,53,FALSE
9279,110,8,206,1,53,52,FALSE
9280,116,17,111,16,97,81,FALSE
9281,174,3,154,4,66,62,FALSE
9282,33,20,226,9,43,34,FALSE
9283,173,14,107,15,21,6,FALSE
9284,151,24,142,20,34,14,FALSE
9285,30,1,292,9,75,66,FALSE
9286,189,1,161,16,93,77,FALSE
9287,43,28,264,2,90,88,FALSE
9288,84,1,52,12,74,62,FALSE
9289,93,22,293,1,79,78,FALSE
9290,186,12,164,9,87,78,FALSE
9291,121,24,134,19,43,24,FALSE
9292,189,27,174,6,72,66,FALSE
9293,163,1,42,12,98,86,FALSE
9294,118,12,48,8,72,64,FALSE
9295,160,27,174,3,36,33,FALSE
9296,134,10,241,9,58,49,FALSE
9297,159,5,31,14,95,81,FALSE
9298,189,28,27,13,28,15,FALSE
9299,78,1,268,3,99,96,FALSE
9300,137,16,142,6,32,26,FALSE
9301,20,24,82,20,67,47,FALSE
9302,139,12,41,14,70,56,FALSE
9303,65,9,272,3,100,97,FALSE
9304,101,27,171,4,59,55,FALSE
9305,104,20,237,4,22,18,FALSE
9306,136,14,141,10,64,54,FALSE
9307,86,19,74,17,32,15,FALSE
9308,158,10,159,11,33,22,FALSE
9309,145,4,41,12,82,70,FALSE
9310,42,21,47,1,67,66,FALSE
9311,43,26,83,1,46,45,FALSE
9312,192,18,189,9,92,83,FALSE
9313,105,6,276,14,91,77,FALSE
9314,177,20,80,11,44,33,FALSE
9315,20,29,147,14,74,60,FALSE
9316,193,3,168,11,81,70,FALSE
9317,104,1,155,16,64,48,FALSE
9318,42,3,200,5,39,34,FALSE
9319,154,23,177,3,53,50,FALSE
9320,128,4,223,1,44,43,FALSE
9321,137,12,163,4,26,22,FALSE
9322,162,9,213,9,78,69,FALSE
9323,70,12,133,9,36,27,FALSE
9324,102,13,62,11,22,11,FALSE
9325,136,6,230,19,90,71,FALSE
9326,120,12,48,19,99,80,FALSE
9327,170,14,123,9,56,47,FALSE
9328,174,3,91,9,62,53,FALSE
9329,27,28,184,12,88,76,FALSE
9330,72,10,254,3,38,35,FALSE
9331,90,4,77,11,29,18,FALSE
9332,167,15,129,12,33,21,FALSE
9333,27,22,246,5,56,51,FALSE
9334,66,20,52,18,97,79,FALSE
9335,180,6,204,18,56,38,FALSE
9336,180,23,64,3,30,27,FALSE
9337,72,1,119,8,90,82,FALSE
9338,24,24,174,15,64,49,FALSE
9339,99,25,294,20,99,79,FALSE
9340,190,26,89,7,62,55,FALSE
9341,52,18,156,15,72,57,FALSE
9342,21,1,259,2,73,71,FALSE
9343,67,27,293,20,63,43,FALSE
9344,191,6,150,5,24,19,FALSE
9345,154,22,274,3,37,34,FALSE
9346,145,23,223,7,44,37,FALSE
9347,84,15,83,17,77,60,FALSE
9348,127,21,162,1,28,27,FALSE
9349,52,13,111,9,45,36,FALSE
9350,112,2,87,2,31,29,FALSE
9351,141,10,51,5,29,24,FALSE
9352,104,4,26,3,83,80,FALSE
9353,188,3,113,14,95,81,FALSE
9354,69,24,209,15,59,44,FALSE
9355,32,28,168,8,37,29,FALSE
9356,42,16,64,11,43,32,FALSE
9357,136,14,205,9,71,62,FALSE
9358,146,13,130,7,84,77,FALSE
9359,130,23,148,12,31,19,FALSE
9360,34,12,169,12,31,19,FALSE
9361,115,21,227,11,67,56,FALSE
9362,92,1,279,9,71,62,FALSE
9363,62,1,65,18,69,51,FALSE
9364,48,11,58,17,69,52,FALSE
9365,62,3,271,10,31,21,FALSE
9366,53,13,214,12,94,82,FALSE
9367,167,22,116,3,96,93,True
9368,32,6,75,15,74,59,FALSE
9369,22,11,196,2,30,28,FALSE
9370,30,19,102,3,40,37,FALSE
9371,50,23,168,11,21,10,FALSE
9372,106,29,103,18,33,15,FALSE
9373,161,29,88,6,52,46,FALSE
9374,134,23,102,3,84,81,FALSE
9375,175,21,260,7,72,65,FALSE
9376,192,18,181,8,25,17,FALSE
9377,123,14,174,4,80,76,FALSE
9378,51,7,246,5,31,26,FALSE
9379,152,8,179,1,62,61,FALSE
9380,84,14,241,20,69,49,FALSE
9381,51,3,105,1,46,45,FALSE
9382,74,15,27,19,93,74,FALSE
9383,86,8,279,6,29,23,FALSE
9384,70,14,119,13,29,16,FALSE
9385,194,13,39,15,57,42,FALSE
9386,21,22,272,12,70,58,FALSE
9387,81,23,158,1,97,96,True
9388,29,20,101,4,30,26,FALSE
9389,69,28,88,1,94,93,FALSE
9390,54,26,281,13,61,48,FALSE
9391,128,17,200,3,89,86,FALSE
9392,154,4,68,10,40,30,FALSE
9393,107,22,132,8,95,87,FALSE
9394,57,17,273,12,72,60,FALSE
9395,79,29,172,9,63,54,FALSE
9396,62,28,223,19,81,62,FALSE
9397,131,15,168,10,86,76,FALSE
9398,100,3,281,17,72,55,FALSE
9399,76,5,67,1,44,43,FALSE
9400,60,26,230,14,67,53,FALSE
9401,42,13,99,15,50,35,FALSE
9402,22,2,256,7,63,56,FALSE
9403,84,6,200,18,51,33,FALSE
9404,112,1,142,3,82,79,FALSE
9405,160,6,130,3,36,33,FALSE
9406,188,11,122,1,55,54,FALSE
9407,40,29,206,17,67,50,FALSE
9408,92,27,269,13,94,81,FALSE
9409,133,9,276,3,86,83,FALSE
9410,28,20,284,11,66,55,FALSE
9411,127,22,38,9,72,63,True
9412,99,15,292,1,39,38,FALSE
9413,110,23,169,17,74,57,FALSE
9414,54,5,119,17,29,12,FALSE
9415,160,23,37,17,64,47,FALSE
9416,23,20,58,1,51,50,FALSE
9417,30,14,32,12,21,9,FALSE
9418,112,16,141,13,95,82,FALSE
9419,173,21,180,1,70,69,FALSE
9420,118,2,274,10,92,82,FALSE
9421,199,13,214,17,52,35,FALSE
9422,53,9,104,1,38,37,FALSE
9423,64,25,214,5,70,65,FALSE
9424,191,3,74,10,54,44,True
9425,23,23,185,18,76,58,FALSE
9426,181,28,183,11,63,52,FALSE
9427,184,16,184,20,33,13,True
9428,81,4,125,3,83,80,FALSE
9429,37,12,60,20,57,37,FALSE
9430,109,22,279,19,93,74,FALSE
9431,62,22,28,17,96,79,FALSE
9432,128,18,109,19,49,30,FALSE
9433,148,27,93,11,22,11,FALSE
9434,93,8,288,17,86,69,FALSE
9435,148,6,128,3,45,42,FALSE
9436,76,26,89,15,71,56,FALSE
9437,45,7,83,5,33,28,FALSE
9438,186,4,197,9,32,23,FALSE
9439,136,22,39,8,74,66,FALSE
9440,94,1,105,14,90,76,FALSE
9441,88,30,58,19,57,38,FALSE
9442,161,5,128,19,65,46,FALSE
9443,47,10,122,6,82,76,FALSE
9444,86,23,59,1,66,65,FALSE
9445,144,9,143,15,22,7,FALSE
9446,137,13,81,14,68,54,FALSE
9447,77,25,51,4,57,53,FALSE
9448,85,6,259,15,97,82,FALSE
9449,190,22,73,8,45,37,FALSE
9450,49,30,69,3,36,33,FALSE
9451,136,2,257,5,84,79,FALSE
9452,70,28,197,10,84,74,FALSE
9453,112,6,236,5,56,51,FALSE
9454,89,18,35,3,99,96,True
9455,150,1,297,18,72,54,FALSE
9456,166,18,121,9,48,39,FALSE
9457,159,4,64,6,83,77,FALSE
9458,53,9,147,19,45,26,FALSE
9459,155,12,27,17,71,54,FALSE
9460,23,1,140,11,56,45,FALSE
9461,112,30,82,7,37,30,FALSE
9462,58,12,125,17,74,57,FALSE
9463,135,12,291,8,51,43,FALSE
9464,40,27,135,10,47,37,FALSE
9465,187,21,98,6,39,33,FALSE
9466,115,1,236,5,38,33,FALSE
9467,93,3,296,7,63,56,FALSE
9468,32,23,123,7,66,59,FALSE
9469,96,3,227,16,70,54,FALSE
9470,196,21,96,7,69,62,FALSE
9471,194,29,267,14,99,85,FALSE
9472,154,29,181,2,60,58,FALSE
9473,85,5,242,19,21,2,FALSE
9474,109,13,103,2,84,82,FALSE
9475,149,24,264,20,99,79,FALSE
9476,41,20,142,9,20,11,FALSE
9477,101,10,25,9,80,71,FALSE
9478,110,5,163,12,73,61,FALSE
9479,49,9,90,9,23,14,FALSE
9480,187,20,92,20,92,72,FALSE
9481,178,12,79,18,96,78,FALSE
9482,92,17,92,9,25,16,FALSE
9483,58,9,219,7,65,58,FALSE
9484,149,30,82,5,65,60,FALSE
9485,64,24,268,15,20,5,FALSE
9486,189,23,99,5,43,38,True
9487,24,17,133,10,41,31,FALSE
9488,26,16,217,15,68,53,FALSE
9489,164,10,239,17,56,39,True
9490,180,28,138,10,25,15,FALSE
9491,36,24,135,20,87,67,FALSE
9492,157,10,166,4,96,92,FALSE
9493,187,13,64,5,36,31,FALSE
9494,31,6,158,16,96,80,FALSE
9495,142,16,263,20,24,4,FALSE
9496,60,13,130,1,78,77,True
9497,147,4,195,10,100,90,FALSE
9498,80,16,255,1,31,30,True
9499,172,9,278,15,22,7,FALSE
9500,188,13,289,10,33,23,FALSE
9501,175,18,111,1,73,72,FALSE
9502,73,18,88,6,70,64,FALSE
9503,43,4,179,14,95,81,FALSE
9504,200,11,148,6,27,21,FALSE
9505,144,4,149,14,27,13,FALSE
9506,38,19,43,16,64,48,FALSE
9507,71,7,204,6,39,33,FALSE
9508,102,30,258,12,46,34,FALSE
9509,125,27,118,3,33,30,FALSE
9510,150,15,170,3,65,62,FALSE
9511,151,13,180,2,96,94,FALSE
9512,163,29,254,8,68,60,FALSE
9513,193,24,297,18,31,13,FALSE
9514,57,22,223,14,27,13,FALSE
9515,180,13,183,7,81,74,FALSE
9516,160,10,215,5,38,33,FALSE
9517,36,6,129,15,78,63,FALSE
9518,118,13,139,6,95,89,FALSE
9519,68,26,145,9,36,27,FALSE
9520,152,6,103,9,68,59,FALSE
9521,149,25,68,1,94,93,FALSE
9522,133,15,242,12,42,30,True
9523,182,21,198,8,63,55,FALSE
9524,20,21,28,20,27,7,FALSE
9525,50,6,129,4,52,48,FALSE
9526,121,14,54,12,91,79,FALSE
9527,148,8,142,8,42,34,FALSE
9528,32,10,175,20,90,70,FALSE
9529,147,22,70,12,58,46,FALSE
9530,111,13,137,6,98,92,FALSE
9531,147,22,106,20,94,74,FALSE
9532,77,10,156,9,34,25,FALSE
9533,150,30,220,3,89,86,True
9534,139,9,230,9,71,62,FALSE
9535,148,9,29,15,32,17,FALSE
9536,30,9,50,2,41,39,FALSE
9537,171,21,189,2,76,74,FALSE
9538,152,3,300,15,77,62,FALSE
9539,92,29,201,4,35,31,FALSE
9540,119,2,105,11,56,45,FALSE
9541,50,19,113,2,38,36,FALSE
9542,113,11,238,19,36,17,FALSE
9543,96,22,212,12,22,10,FALSE
9544,68,1,168,12,83,71,FALSE
9545,149,4,84,5,76,71,FALSE
9546,164,16,145,18,38,20,FALSE
9547,113,6,278,11,68,57,FALSE
9548,154,4,217,16,39,23,FALSE
9549,87,4,72,10,49,39,FALSE
9550,169,7,125,5,96,91,FALSE
9551,70,8,208,12,21,9,FALSE
9552,108,3,103,15,87,72,True
9553,39,1,176,13,30,17,FALSE
9554,189,17,158,3,65,62,FALSE
9555,77,30,233,17,80,63,FALSE
9556,86,23,228,5,71,66,True
9557,141,29,239,13,92,79,FALSE
9558,185,26,58,9,32,23,FALSE
9559,148,22,130,8,70,62,FALSE
9560,176,30,153,19,90,71,FALSE
9561,117,23,224,9,77,68,FALSE
9562,165,1,31,20,23,3,FALSE
9563,61,10,161,12,75,63,FALSE
9564,98,17,211,10,42,32,FALSE
9565,194,26,64,12,47,35,FALSE
9566,101,14,282,6,51,45,FALSE
9567,198,3,198,9,65,56,FALSE
9568,166,4,231,2,83,81,FALSE
9569,136,17,200,15,77,62,FALSE
9570,84,15,24,8,27,19,FALSE
9571,65,10,32,7,32,25,FALSE
9572,169,7,285,6,54,48,FALSE
9573,198,3,216,16,41,25,FALSE
9574,128,23,274,10,29,19,FALSE
9575,141,27,170,11,35,24,FALSE
9576,179,18,215,3,69,66,FALSE
9577,190,11,136,3,45,42,FALSE
9578,133,23,102,1,45,44,FALSE
9579,87,29,144,9,58,49,True
9580,103,3,58,3,78,75,FALSE
9581,41,20,160,9,58,49,FALSE
9582,193,26,238,17,94,77,FALSE
9583,91,11,105,20,86,66,FALSE
9584,149,7,81,17,49,32,FALSE
9585,46,20,131,8,86,78,FALSE
9586,105,7,179,10,66,56,FALSE
9587,93,29,34,17,49,32,FALSE
9588,40,1,244,3,20,17,FALSE
9589,106,9,92,11,47,36,FALSE
9590,200,10,40,12,56,44,FALSE
9591,176,22,281,1,53,52,FALSE
9592,116,28,187,19,43,24,FALSE
9593,56,24,150,4,50,46,FALSE
9594,137,29,95,1,99,98,FALSE
9595,156,29,290,14,71,57,FALSE
9596,37,10,252,3,99,96,FALSE
9597,31,17,269,5,21,16,FALSE
9598,175,8,257,5,79,74,FALSE
9599,85,17,147,9,78,69,FALSE
9600,31,2,180,14,75,61,FALSE
9601,128,7,110,11,64,53,FALSE
9602,150,4,281,7,21,14,FALSE
9603,200,20,22,7,46,39,FALSE
9604,35,14,219,12,77,65,True
9605,52,8,98,1,33,32,FALSE
9606,161,22,30,5,73,68,FALSE
9607,47,3,160,14,70,56,FALSE
9608,142,7,112,13,26,13,FALSE
9609,159,16,278,5,98,93,FALSE
9610,120,26,175,15,26,11,FALSE
9611,74,13,196,10,100,90,FALSE
9612,151,27,26,5,28,23,FALSE
9613,115,8,293,17,39,22,FALSE
9614,117,27,192,10,66,56,FALSE
9615,115,19,64,16,41,25,FALSE
9616,53,6,147,13,65,52,FALSE
9617,113,4,121,9,85,76,FALSE
9618,124,5,271,14,38,24,FALSE
9619,37,27,101,17,25,8,FALSE
9620,183,5,268,18,25,7,FALSE
9621,124,29,209,11,71,60,FALSE
9622,111,24,23,1,53,52,FALSE
9623,106,19,141,19,61,42,FALSE
9624,130,7,42,9,41,32,FALSE
9625,164,14,247,7,99,92,FALSE
9626,197,28,237,9,29,20,FALSE
9627,111,6,122,3,63,60,True
9628,156,14,82,2,88,86,FALSE
9629,42,19,241,11,31,20,FALSE
9630,92,1,192,19,92,73,FALSE
9631,38,9,247,11,55,44,FALSE
9632,161,11,262,1,70,69,FALSE
9633,85,9,102,9,28,19,FALSE
9634,104,16,218,8,27,19,FALSE
9635,92,25,182,19,49,30,FALSE
9636,170,12,55,17,74,57,FALSE
9637,56,9,156,15,68,53,FALSE
9638,159,3,94,18,61,43,FALSE
9639,76,15,216,11,28,17,FALSE
9640,146,23,166,4,82,78,FALSE
9641,23,5,146,12,80,68,FALSE
9642,83,13,184,18,32,14,FALSE
9643,47,3,145,5,46,41,FALSE
9644,194,30,197,4,96,92,FALSE
9645,149,22,295,15,72,57,FALSE
9646,146,9,29,3,56,53,FALSE
9647,109,8,233,18,82,64,FALSE
9648,183,8,36,7,23,16,FALSE
9649,118,15,175,11,66,55,FALSE
9650,32,22,71,7,29,22,FALSE
9651,98,9,109,10,52,42,FALSE
9652,157,22,201,10,51,41,FALSE
9653,98,12,286,18,92,74,FALSE
9654,94,10,225,9,74,65,FALSE
9655,33,19,137,19,46,27,FALSE
9656,83,16,268,8,81,73,FALSE
9657,110,17,137,1,34,33,FALSE
9658,79,19,188,10,39,29,FALSE
9659,132,26,293,11,69,58,FALSE
9660,164,14,284,2,95,93,FALSE
9661,69,13,119,19,22,3,FALSE
9662,143,13,277,1,81,80,FALSE
9663,59,2,33,4,69,65,FALSE
9664,113,12,145,12,61,49,True
9665,115,23,296,18,89,71,FALSE
9666,122,11,45,15,44,29,FALSE
9667,138,22,259,15,25,10,FALSE
9668,186,11,129,14,50,36,FALSE
9669,20,23,46,8,74,66,FALSE
9670,59,1,132,4,47,43,FALSE
9671,42,30,189,19,82,63,FALSE
9672,159,24,71,2,74,72,FALSE
9673,158,29,215,12,84,72,True
9674,92,28,236,12,62,50,FALSE
9675,98,5,119,15,83,68,FALSE
9676,48,13,257,16,99,83,FALSE
9677,149,18,72,15,90,75,FALSE
9678,109,27,138,5,100,95,FALSE
9679,125,5,234,1,100,99,FALSE
9680,46,23,239,11,96,85,FALSE
9681,126,12,299,6,21,15,FALSE
9682,61,18,70,1,34,33,FALSE
9683,26,29,257,12,36,24,FALSE
9684,76,23,130,9,61,52,FALSE
9685,165,9,145,18,74,56,FALSE
9686,136,15,43,7,36,29,FALSE
9687,167,26,234,14,33,19,FALSE
9688,43,11,49,8,30,22,FALSE
9689,156,16,157,10,51,41,FALSE
9690,49,5,227,8,73,65,FALSE
9691,100,16,90,19,75,56,FALSE
9692,37,8,256,20,58,38,FALSE
9693,65,12,267,12,32,20,FALSE
9694,85,14,210,6,73,67,FALSE
9695,150,10,169,3,46,43,FALSE
9696,39,13,108,9,47,38,FALSE
9697,135,21,209,13,52,39,FALSE
9698,192,14,151,5,42,37,FALSE
9699,109,4,134,17,57,40,FALSE
9700,86,28,205,1,65,64,FALSE
9701,94,24,83,5,81,76,FALSE
9702,29,6,297,8,86,78,FALSE
9703,34,8,261,3,98,95,FALSE
9704,109,18,20,11,55,44,FALSE
9705,52,28,87,16,63,47,FALSE
9706,140,16,201,10,27,17,FALSE
9707,58,28,170,3,68,65,FALSE
9708,21,6,243,9,58,49,FALSE
9709,145,24,125,12,97,85,FALSE
9710,113,5,222,14,87,73,FALSE
9711,86,10,183,19,64,45,FALSE
9712,165,25,112,6,52,46,FALSE
9713,146,8,109,8,64,56,FALSE
9714,42,13,72,14,72,58,True
9715,170,13,158,14,36,22,FALSE
9716,69,30,28,3,76,73,FALSE
9717,163,18,192,12,53,41,FALSE
9718,20,4,197,14,95,81,FALSE
9719,37,10,60,2,77,75,FALSE
9720,39,16,182,4,93,89,FALSE
9721,152,25,100,20,76,56,FALSE
9722,107,18,271,7,51,44,FALSE
9723,31,5,222,10,74,64,FALSE
9724,161,2,242,8,92,84,FALSE
9725,71,29,272,9,46,37,FALSE
9726,96,28,23,16,32,16,FALSE
9727,21,7,286,7,37,30,FALSE
9728,134,2,171,9,44,35,FALSE
9729,105,2,263,19,22,3,FALSE
9730,99,7,293,6,93,87,FALSE
9731,115,26,298,1,97,96,FALSE
9732,112,16,194,7,95,88,FALSE
9733,174,21,190,10,63,53,FALSE
9734,22,29,184,13,88,75,FALSE
9735,102,30,119,2,55,53,FALSE
9736,115,4,207,3,80,77,FALSE
9737,131,9,223,16,37,21,FALSE
9738,181,9,119,6,67,61,FALSE
9739,73,27,128,8,21,13,FALSE
9740,84,24,222,1,81,80,FALSE
9741,104,18,160,10,72,62,FALSE
9742,157,13,25,7,42,35,FALSE
9743,157,15,101,19,99,80,FALSE
9744,191,3,278,16,40,24,FALSE
9745,113,30,239,15,49,34,FALSE
9746,37,23,232,12,40,28,FALSE
9747,22,27,50,13,93,80,FALSE
9748,48,1,84,18,79,61,FALSE
9749,43,21,257,9,31,22,FALSE
9750,88,30,173,9,64,55,FALSE
9751,100,18,233,8,89,81,FALSE
9752,32,22,219,14,88,74,FALSE
9753,26,28,280,13,94,81,FALSE
9754,140,19,174,10,71,61,FALSE
9755,37,11,43,11,39,28,FALSE
9756,75,16,69,4,95,91,FALSE
9757,55,12,266,2,42,40,FALSE
9758,140,4,139,10,39,29,FALSE
9759,128,28,244,20,23,3,FALSE
9760,132,20,136,19,31,12,FALSE
9761,121,3,261,17,79,62,FALSE
9762,176,7,254,13,27,14,FALSE
9763,173,4,142,19,96,77,FALSE
9764,75,11,103,1,72,71,FALSE
9765,69,22,42,17,51,34,FALSE
9766,107,25,92,6,94,88,FALSE
9767,166,14,183,14,75,61,FALSE
9768,35,12,112,1,20,19,FALSE
9769,189,8,91,11,68,57,FALSE
9770,37,17,101,8,75,67,FALSE
9771,131,23,90,16,70,54,FALSE
9772,171,24,45,11,27,16,FALSE
9773,57,16,25,5,70,65,FALSE
9774,157,1,122,16,31,15,FALSE
9775,84,22,234,17,100,83,FALSE
9776,140,2,30,16,23,7,FALSE
9777,92,19,148,1,20,19,FALSE
9778,124,11,215,5,69,64,FALSE
9779,72,29,105,15,80,65,FALSE
9780,71,1,265,1,27,26,FALSE
9781,154,25,193,17,57,40,FALSE
9782,49,1,227,11,69,58,FALSE
9783,136,29,99,18,74,56,FALSE
9784,127,20,182,15,36,21,FALSE
9785,144,14,138,20,21,1,FALSE
9786,119,20,89,4,70,66,FALSE
9787,150,15,184,12,81,69,FALSE
9788,154,30,203,12,31,19,FALSE
9789,159,7,62,14,55,41,FALSE
9790,99,27,98,20,84,64,FALSE
9791,29,27,72,3,66,63,FALSE
9792,106,3,265,15,81,66,FALSE
9793,189,14,195,19,47,28,FALSE
9794,109,29,299,13,89,76,FALSE
9795,179,3,254,17,59,42,FALSE
9796,198,19,49,6,29,23,FALSE
9797,71,8,121,7,92,85,FALSE
9798,117,10,119,4,100,96,FALSE
9799,154,5,75,13,77,64,FALSE
9800,148,3,109,14,39,25,FALSE
9801,36,18,39,9,97,88,FALSE
9802,68,21,27,18,49,31,FALSE
9803,185,30,139,17,89,72,FALSE
9804,170,29,298,3,80,77,FALSE
9805,103,1,148,3,82,79,FALSE
9806,190,1,257,18,78,60,FALSE
9807,198,25,42,14,94,80,FALSE
9808,42,11,152,20,40,20,FALSE
9809,168,12,222,6,34,28,FALSE
9810,35,17,101,17,97,80,FALSE
9811,81,3,94,14,57,43,FALSE
9812,200,10,228,3,48,45,FALSE
9813,121,22,267,2,76,74,FALSE
9814,188,25,87,3,91,88,FALSE
9815,39,29,37,14,82,68,FALSE
9816,99,5,91,12,46,34,FALSE
9817,71,9,291,8,73,65,FALSE
9818,157,6,59,18,59,41,FALSE
9819,194,11,194,6,59,53,FALSE
9820,76,5,56,5,64,59,FALSE
9821,89,15,57,5,92,87,FALSE
9822,140,20,152,12,30,18,FALSE
9823,50,20,252,1,72,71,FALSE
9824,59,27,56,18,26,8,FALSE
9825,54,1,267,20,94,74,FALSE
9826,142,3,287,10,71,61,FALSE
9827,107,24,295,2,50,48,FALSE
9828,177,30,68,5,99,94,FALSE
9829,132,30,30,2,82,80,FALSE
9830,65,28,163,19,45,26,FALSE
9831,183,29,262,9,90,81,FALSE
9832,70,8,49,16,41,25,FALSE
9833,194,18,144,9,48,39,FALSE
9834,81,28,157,18,62,44,FALSE
9835,137,12,126,8,95,87,FALSE
9836,129,15,223,12,43,31,FALSE
9837,90,22,80,6,98,92,FALSE
9838,69,26,274,7,29,22,FALSE
9839,116,11,67,8,55,47,FALSE
9840,182,11,185,15,82,67,FALSE
9841,26,3,295,4,83,79,FALSE
9842,114,4,241,14,23,9,FALSE
9843,114,26,246,4,74,70,FALSE
9844,46,22,146,1,84,83,FALSE
9845,118,20,208,9,53,44,FALSE
9846,93,2,258,4,97,93,FALSE
9847,115,26,186,20,84,64,FALSE
9848,51,19,137,8,52,44,FALSE
9849,111,12,149,16,31,15,FALSE
9850,80,6,237,15,70,55,FALSE
9851,64,26,190,13,22,9,FALSE
9852,51,30,29,16,73,57,FALSE
9853,169,27,227,17,79,62,FALSE
9854,31,29,131,9,98,89,FALSE
9855,98,24,111,10,62,52,FALSE
9856,88,11,187,7,32,25,FALSE
9857,147,23,149,5,62,57,FALSE
9858,155,22,268,3,85,82,FALSE
9859,71,5,27,13,47,34,FALSE
9860,115,3,269,18,50,32,FALSE
9861,168,15,250,20,91,71,FALSE
9862,66,8,275,14,78,64,FALSE
9863,61,9,112,10,21,11,FALSE
9864,69,19,169,6,33,27,FALSE
9865,100,9,261,12,24,12,FALSE
9866,92,13,124,19,91,72,FALSE
9867,44,3,90,19,81,62,FALSE
9868,152,11,218,18,33,15,FALSE
9869,60,21,203,4,91,87,FALSE
9870,38,18,284,14,78,64,FALSE
9871,199,13,215,20,66,46,FALSE
9872,121,8,266,3,71,68,FALSE
9873,193,12,198,15,39,24,FALSE
9874,146,3,56,2,48,46,FALSE
9875,180,29,204,8,88,80,FALSE
9876,168,16,193,4,45,41,FALSE
9877,22,18,21,11,28,17,FALSE
9878,127,16,27,19,21,2,FALSE
9879,152,18,80,1,37,36,FALSE
9880,31,25,71,19,61,42,FALSE
9881,164,18,106,17,55,38,FALSE
9882,116,2,63,18,27,9,FALSE
9883,46,8,47,10,23,13,FALSE
9884,108,25,242,9,68,59,FALSE
9885,105,6,44,12,60,48,FALSE
9886,137,4,59,4,69,65,FALSE
9887,145,3,215,11,62,51,FALSE
9888,67,8,24,6,60,54,FALSE
9889,57,27,270,11,24,13,FALSE
9890,52,27,297,4,63,59,FALSE
9891,73,14,140,20,66,46,FALSE
9892,31,18,220,17,59,42,FALSE
9893,42,5,35,15,65,50,FALSE
9894,123,24,246,10,26,16,FALSE
9895,106,20,235,13,20,7,FALSE
9896,70,21,92,1,89,88,FALSE
9897,159,29,133,8,50,42,FALSE
9898,49,29,243,17,26,9,FALSE
9899,199,18,187,6,54,48,FALSE
9900,161,8,177,13,66,53,FALSE
9901,27,6,127,11,30,19,FALSE
9902,76,2,47,7,21,14,FALSE
9903,166,11,78,9,90,81,FALSE
9904,108,1,216,2,21,19,FALSE
9905,75,25,108,10,99,89,FALSE
9906,38,3,279,7,60,53,FALSE
9907,86,26,29,6,48,42,FALSE
9908,80,11,108,4,63,59,FALSE
9909,53,14,300,1,31,30,FALSE
9910,67,4,22,19,22,3,FALSE
9911,171,28,41,4,50,46,FALSE
9912,57,23,72,13,95,82,FALSE
9913,78,16,147,3,70,67,FALSE
9914,191,13,23,15,56,41,FALSE
9915,104,5,60,6,28,22,FALSE
9916,149,19,182,20,70,50,FALSE
9917,129,4,144,9,100,91,FALSE
9918,110,8,283,13,39,26,FALSE
9919,42,29,57,2,87,85,FALSE
9920,80,13,268,6,78,72,FALSE
9921,112,8,93,7,59,52,FALSE
9922,200,20,46,17,88,71,FALSE
9923,156,25,50,1,58,57,FALSE
9924,164,14,91,1,40,39,FALSE
9925,139,2,155,20,42,22,FALSE
9926,134,9,99,2,100,98,FALSE
9927,192,14,119,19,40,21,FALSE
9928,158,16,155,6,28,22,FALSE
9929,37,27,143,4,63,59,FALSE
9930,142,9,90,11,23,12,FALSE
9931,158,13,123,13,70,57,FALSE
9932,60,13,166,16,57,41,True
9933,152,11,264,11,79,68,FALSE
9934,139,18,124,2,72,70,FALSE
9935,99,27,174,17,96,79,FALSE
9936,189,27,116,19,55,36,FALSE
9937,21,24,115,11,48,37,FALSE
9938,192,24,214,3,99,96,FALSE
9939,69,11,141,5,90,85,FALSE
9940,101,21,229,2,39,37,FALSE
9941,196,4,92,11,100,89,FALSE
9942,130,13,83,8,99,91,FALSE
9943,127,26,116,7,81,74,FALSE
9944,190,27,283,20,74,54,FALSE
9945,55,6,204,16,56,40,True
9946,170,22,124,12,74,62,FALSE
9947,109,11,273,2,20,18,FALSE
9948,41,23,110,19,81,62,FALSE
9949,25,9,135,9,47,38,FALSE
9950,153,9,265,18,78,60,True
9951,93,9,27,13,70,57,FALSE
9952,198,26,48,2,52,50,FALSE
9953,123,30,107,2,40,38,FALSE
9954,95,1,168,13,92,79,FALSE
9955,58,7,270,8,75,67,FALSE
9956,31,3,175,15,54,39,FALSE
9957,181,12,82,3,49,46,FALSE
9958,132,6,94,9,83,74,FALSE
9959,116,26,48,9,74,65,FALSE
9960,34,11,280,12,70,58,True
9961,82,4,165,17,23,6,FALSE
9962,74,8,228,8,71,63,FALSE
9963,177,14,62,5,65,60,FALSE
9964,125,1,27,7,97,90,FALSE
9965,67,20,79,16,74,58,FALSE
9966,99,21,278,13,68,55,FALSE
9967,47,13,155,10,29,19,FALSE
9968,88,28,101,20,40,20,FALSE
9969,171,20,146,2,66,64,FALSE
9970,98,19,113,17,20,3,FALSE
9971,20,25,208,2,23,21,FALSE
9972,175,6,72,18,96,78,FALSE
9973,29,1,158,11,75,64,FALSE
9974,54,4,275,9,66,57,FALSE
9975,29,6,200,8,62,54,FALSE
9976,102,20,133,1,43,42,FALSE
9977,185,14,32,4,39,35,FALSE
9978,147,14,111,10,57,47,FALSE
9979,120,13,165,16,28,12,FALSE
9980,129,21,288,1,83,82,FALSE
9981,196,15,122,2,31,29,FALSE
9982,158,19,250,11,49,38,FALSE
9983,51,6,85,2,51,49,FALSE
9984,95,30,262,3,29,26,FALSE
9985,148,13,239,13,96,83,FALSE
9986,155,8,79,18,62,44,FALSE
9987,183,13,69,3,44,41,FALSE
9988,82,9,203,13,83,70,FALSE
9989,70,2,34,16,35,19,FALSE
9990,23,16,237,1,75,74,FALSE
9991,185,9,284,13,91,78,FALSE
9992,152,29,25,20,63,43,FALSE
9993,70,30,169,10,24,14,FALSE
9994,184,26,80,13,59,46,FALSE
9995,152,10,206,4,97,93,FALSE
9996,182,15,192,9,84,75,FALSE
9997,42,23,88,6,90,84,FALSE
9998,75,7,198,12,86,74,FALSE
9999,38,20,186,12,55,43,FALSE
10000,34,2,228,15,52,37,FALSE
10001,77,16,240,5,26,21,FALSE
10002,70,21,265,14,82,68,FALSE
10003,23,1,77,8,47,39,FALSE
10004,187,23,65,11,88,77,FALSE
10005,45,20,138,4,58,54,FALSE
10006,41,3,20,20,98,78,FALSE
10007,99,13,243,4,47,43,FALSE
10008,145,2,262,20,91,71,FALSE
10009,35,26,267,2,98,96,FALSE
10010,49,8,48,8,75,67,FALSE
10011,161,26,81,13,28,15,FALSE
10012,154,10,270,17,56,39,FALSE
10013,49,4,65,6,30,24,FALSE
10014,163,19,203,5,32,27,FALSE
10015,146,9,191,16,64,48,FALSE
10016,182,7,251,5,91,86,FALSE
10017,51,10,22,12,39,27,FALSE
10018,120,20,24,14,29,15,FALSE
10019,79,14,262,10,54,44,FALSE
10020,134,2,136,14,78,64,FALSE
10021,56,10,273,18,54,36,FALSE
10022,96,18,148,4,47,43,FALSE
10023,41,21,36,14,68,54,FALSE
10024,179,21,129,13,23,10,FALSE
10025,170,8,55,3,37,34,FALSE
10026,86,21,85,7,35,28,FALSE
10027,56,28,158,16,54,38,FALSE
10028,82,10,25,13,45,32,FALSE
10029,41,22,251,20,41,21,FALSE
10030,99,19,295,11,97,86,FALSE
10031,142,9,142,18,95,77,FALSE
10032,184,4,133,19,50,31,FALSE
10033,175,24,47,18,25,7,FALSE
10034,109,4,142,12,89,77,FALSE
10035,33,5,211,11,31,20,FALSE
10036,138,6,266,19,95,76,FALSE
10037,123,21,264,11,90,79,FALSE
10038,106,8,101,12,96,84,FALSE
10039,67,1,230,10,48,38,FALSE
10040,107,25,291,12,57,45,FALSE
10041,86,20,192,19,72,53,FALSE
10042,22,19,111,10,35,25,FALSE
10043,49,9,213,20,94,74,FALSE
10044,31,4,242,18,91,73,FALSE
10045,55,29,39,16,87,71,FALSE
10046,119,21,212,8,32,24,True
10047,172,8,235,2,45,43,FALSE
10048,52,21,159,3,78,75,FALSE
10049,181,4,238,14,24,10,FALSE
10050,33,9,122,4,71,67,FALSE
10051,39,6,169,19,89,70,FALSE
10052,21,22,181,10,93,83,FALSE
10053,44,2,190,20,76,56,FALSE
10054,127,23,112,11,60,49,FALSE
10055,62,15,154,7,38,31,FALSE
10056,42,8,179,20,44,24,FALSE
10057,146,4,125,11,65,54,FALSE
10058,64,18,270,20,66,46,FALSE
10059,63,17,41,15,20,5,FALSE
10060,54,5,180,12,51,39,FALSE
10061,76,10,138,20,40,20,FALSE
10062,181,18,34,9,50,41,FALSE
10063,22,9,282,16,20,4,FALSE
10064,96,9,164,20,55,35,FALSE
10065,49,12,84,20,45,25,FALSE
10066,97,13,152,9,94,85,FALSE
10067,142,29,223,15,36,21,FALSE
10068,188,3,278,10,49,39,FALSE
10069,34,28,71,13,82,69,FALSE
10070,26,9,240,15,38,23,FALSE
10071,146,18,245,9,61,52,FALSE
10072,188,10,51,1,52,51,FALSE
10073,145,11,65,7,96,89,FALSE
10074,125,13,186,17,80,63,FALSE
10075,171,6,211,5,93,88,FALSE
10076,129,24,175,11,44,33,FALSE
10077,51,6,287,1,73,72,FALSE
10078,77,14,127,4,30,26,FALSE
10079,64,12,46,2,81,79,FALSE
10080,56,6,274,19,62,43,FALSE
10081,110,21,138,19,21,2,FALSE
10082,170,3,50,18,95,77,FALSE
10083,35,4,265,7,34,27,FALSE
10084,114,17,33,11,53,42,FALSE
10085,36,29,276,19,45,26,FALSE
10086,158,9,246,18,99,81,FALSE
10087,100,16,268,17,92,75,FALSE
10088,108,16,289,5,72,67,FALSE
10089,48,29,209,5,87,82,FALSE
10090,160,18,296,3,51,48,FALSE
10091,161,30,286,14,99,85,FALSE
10092,190,28,245,13,87,74,FALSE
10093,73,21,279,16,45,29,FALSE
10094,59,22,277,9,58,49,FALSE
10095,175,3,25,12,38,26,FALSE
10096,54,19,52,19,29,10,FALSE
10097,175,28,256,20,35,15,FALSE
10098,26,8,89,14,70,56,FALSE
10099,171,9,300,19,38,19,FALSE
10100,21,20,69,13,31,18,FALSE
10101,176,3,253,13,100,87,FALSE
10102,47,30,122,3,22,19,FALSE
10103,65,21,36,4,27,23,FALSE
10104,31,11,25,17,46,29,FALSE
10105,151,4,143,16,23,7,FALSE
10106,76,12,91,5,45,40,FALSE
10107,127,15,270,3,42,39,FALSE
10108,146,10,176,15,20,5,FALSE
10109,119,19,228,3,31,28,FALSE
10110,47,5,106,1,58,57,True
10111,158,18,29,5,34,29,FALSE
10112,29,20,159,5,33,28,FALSE
10113,128,7,68,10,28,18,FALSE
10114,123,5,192,7,40,33,True
10115,140,20,119,18,96,78,FALSE
10116,73,5,157,9,91,82,FALSE
10117,71,2,227,2,59,57,FALSE
10118,61,23,288,10,93,83,FALSE
10119,71,7,224,2,60,58,FALSE
10120,148,14,34,2,98,96,FALSE
10121,51,21,274,7,95,88,FALSE
10122,33,2,136,12,34,22,FALSE
10123,189,25,85,9,97,88,FALSE
10124,161,8,109,4,96,92,FALSE
10125,140,7,219,20,94,74,FALSE
10126,83,25,71,9,33,24,FALSE
10127,130,3,168,1,43,42,FALSE
10128,87,5,184,2,98,96,FALSE
10129,93,5,126,15,20,5,FALSE
10130,90,14,179,7,87,80,FALSE
10131,22,24,163,16,81,65,FALSE
10132,57,8,27,16,96,80,FALSE
10133,181,30,102,6,93,87,FALSE
10134,196,9,205,15,99,84,FALSE
10135,126,19,58,10,62,52,FALSE
10136,145,17,179,8,27,19,FALSE
10137,119,21,64,19,78,59,FALSE
10138,131,25,145,6,61,55,FALSE
10139,149,20,33,7,90,83,FALSE
10140,26,27,67,12,63,51,FALSE
10141,64,7,46,16,58,42,FALSE
10142,90,10,107,17,47,30,FALSE
10143,52,18,190,14,77,63,FALSE
10144,51,14,98,16,87,71,FALSE
10145,71,11,229,6,65,59,FALSE
10146,94,16,56,2,34,32,FALSE
10147,96,7,63,9,36,27,FALSE
10148,179,20,50,8,26,18,True
10149,31,18,206,3,63,60,FALSE
10150,38,15,23,2,30,28,FALSE
10151,38,10,168,1,34,33,FALSE
10152,152,22,270,7,53,46,FALSE
10153,148,5,262,17,73,56,FALSE
10154,131,1,269,7,51,44,FALSE
10155,90,9,124,12,32,20,FALSE
10156,59,13,280,15,48,33,FALSE
10157,157,19,290,20,73,53,FALSE
10158,148,28,250,12,78,66,True
10159,138,22,117,3,36,33,FALSE
10160,116,27,137,12,58,46,FALSE
10161,61,29,104,4,61,57,FALSE
10162,108,4,236,10,21,11,FALSE
10163,83,29,62,6,43,37,FALSE
10164,191,25,236,5,46,41,FALSE
10165,98,4,77,3,57,54,FALSE
10166,178,10,77,7,29,22,FALSE
10167,148,20,53,2,46,44,FALSE
10168,125,19,269,20,26,6,FALSE
10169,138,14,259,14,83,69,FALSE
10170,191,23,134,16,56,40,FALSE
10171,192,2,105,20,98,78,FALSE
10172,188,7,156,6,27,21,FALSE
10173,22,24,119,1,40,39,FALSE
10174,88,25,21,19,25,6,FALSE
10175,40,13,67,15,29,14,True
10176,161,9,87,7,72,65,FALSE
10177,187,20,78,5,30,25,FALSE
10178,62,27,127,17,63,46,FALSE
10179,189,3,113,20,43,23,FALSE
10180,174,24,223,17,74,57,FALSE
10181,32,5,219,11,65,54,FALSE
10182,97,10,58,13,100,87,FALSE
10183,178,14,155,15,100,85,FALSE
10184,105,1,241,11,42,31,FALSE
10185,77,26,271,13,75,62,FALSE
10186,187,30,247,9,78,69,FALSE
10187,30,1,53,8,23,15,FALSE
10188,21,6,21,14,26,12,FALSE
10189,137,9,86,20,72,52,FALSE
10190,128,6,87,8,77,69,FALSE
10191,184,10,248,2,85,83,FALSE
10192,153,7,91,14,51,37,FALSE
10193,44,8,175,17,82,65,FALSE
10194,68,9,286,8,100,92,FALSE
10195,47,9,165,9,77,68,FALSE
10196,188,20,111,19,24,5,FALSE
10197,177,5,219,2,47,45,FALSE
10198,44,27,243,20,45,25,FALSE
10199,74,9,235,17,61,44,FALSE
10200,169,8,220,8,85,77,FALSE
10201,42,24,65,16,71,55,FALSE
10202,49,4,22,8,69,61,FALSE
10203,176,16,254,17,68,51,FALSE
10204,179,13,109,5,47,42,FALSE
10205,32,30,231,17,62,45,FALSE
10206,113,27,142,2,87,85,FALSE
10207,64,1,144,7,99,92,FALSE
10208,128,7,297,17,65,48,FALSE
10209,49,4,38,9,53,44,FALSE
10210,82,20,145,1,85,84,FALSE
10211,185,5,97,15,80,65,FALSE
10212,141,8,42,13,36,23,True
10213,146,24,109,14,36,22,FALSE
10214,103,18,143,4,43,39,FALSE
10215,49,7,101,17,81,64,FALSE
10216,174,30,101,17,34,17,FALSE
10217,197,30,252,16,88,72,FALSE
10218,124,23,148,6,83,77,FALSE
10219,20,12,241,18,24,6,FALSE
10220,82,2,55,19,88,69,FALSE
10221,91,1,99,14,35,21,FALSE
10222,164,14,194,13,48,35,True
10223,140,13,118,11,58,47,FALSE
10224,173,20,62,9,28,19,FALSE
10225,189,5,100,4,31,27,FALSE
10226,179,12,140,4,83,79,FALSE
10227,129,23,284,20,88,68,FALSE
10228,139,17,61,16,83,67,FALSE
10229,159,29,52,20,57,37,FALSE
10230,177,30,64,10,85,75,FALSE
10231,87,2,297,9,24,15,FALSE
10232,104,26,289,1,69,68,FALSE
10233,37,20,128,14,30,16,FALSE
10234,36,9,172,7,35,28,FALSE
10235,75,30,218,9,95,86,FALSE
10236,86,17,150,13,39,26,FALSE
10237,186,22,250,20,23,3,FALSE
10238,101,24,35,13,61,48,FALSE
10239,154,11,239,2,98,96,FALSE
10240,162,25,206,11,51,40,FALSE
10241,56,9,192,5,69,64,FALSE
10242,87,12,256,4,74,70,FALSE
10243,113,28,116,14,75,61,FALSE
10244,164,15,130,7,51,44,FALSE
10245,156,21,194,5,86,81,FALSE
10246,61,13,84,18,54,36,FALSE
10247,91,14,84,5,42,37,FALSE
10248,25,13,130,6,59,53,FALSE
10249,52,16,53,18,66,48,FALSE
10250,90,16,135,3,97,94,True
10251,127,23,225,6,79,73,FALSE
10252,66,26,281,2,76,74,FALSE
10253,111,24,50,7,70,63,FALSE
10254,101,14,154,20,20,0,FALSE
10255,135,18,124,8,26,18,FALSE
10256,42,17,52,17,56,39,FALSE
10257,83,24,255,9,69,60,FALSE
10258,60,16,163,8,92,84,FALSE
10259,153,19,244,19,53,34,FALSE
10260,46,3,139,13,93,80,FALSE
10261,46,24,234,7,72,65,FALSE
10262,61,21,250,19,27,8,FALSE
10263,45,7,165,4,74,70,FALSE
10264,94,3,181,20,85,65,FALSE
10265,107,15,89,11,77,66,FALSE
10266,91,1,240,17,62,45,FALSE
10267,65,21,297,16,98,82,FALSE
10268,179,2,72,3,47,44,FALSE
10269,112,10,51,7,84,77,FALSE
10270,128,9,274,4,93,89,FALSE
10271,191,12,215,10,58,48,FALSE
10272,48,26,45,18,38,20,FALSE
10273,78,6,170,8,52,44,FALSE
10274,98,13,269,5,80,75,FALSE
10275,193,4,251,11,37,26,FALSE
10276,27,16,69,8,69,61,FALSE
10277,85,2,285,10,77,67,FALSE
10278,83,7,169,7,98,91,FALSE
10279,85,21,160,4,79,75,FALSE
10280,188,11,23,20,21,1,FALSE
10281,63,23,95,15,73,58,FALSE
10282,178,16,78,16,61,45,FALSE
10283,184,9,42,14,24,10,FALSE
10284,70,9,86,17,82,65,FALSE
10285,145,28,101,20,62,42,FALSE
10286,54,30,161,7,100,93,FALSE
10287,75,29,140,4,41,37,FALSE
10288,27,13,270,18,75,57,FALSE
10289,48,24,286,6,46,40,FALSE
10290,150,13,145,9,71,62,True
10291,142,12,42,14,28,14,FALSE
10292,181,4,161,8,77,69,FALSE
10293,28,22,61,12,69,57,FALSE
10294,167,13,91,17,98,81,FALSE
10295,48,3,274,2,93,91,FALSE
10296,120,27,193,20,93,73,FALSE
10297,186,6,286,8,83,75,FALSE
10298,137,8,95,2,93,91,FALSE
10299,168,13,53,16,60,44,FALSE
10300,63,24,290,15,33,18,FALSE
10301,125,20,58,7,83,76,FALSE
10302,183,22,42,6,26,20,FALSE
10303,82,22,194,20,58,38,FALSE
10304,131,29,69,3,21,18,FALSE
10305,137,26,230,17,30,13,FALSE
10306,113,18,110,6,82,76,FALSE
10307,88,3,45,13,36,23,True
10308,52,8,101,5,73,68,FALSE
10309,52,2,177,4,83,79,FALSE
10310,36,13,262,4,44,40,FALSE
10311,196,2,244,5,46,41,FALSE
10312,22,28,215,20,90,70,FALSE
10313,182,2,159,2,41,39,True
10314,200,11,95,12,99,87,FALSE
10315,96,23,225,13,93,80,FALSE
10316,87,4,141,5,54,49,FALSE
10317,178,13,176,8,25,17,FALSE
10318,110,22,193,5,65,60,FALSE
10319,98,15,186,8,87,79,FALSE
10320,83,9,291,4,74,70,True
10321,126,14,88,13,57,44,FALSE
10322,84,3,206,9,95,86,FALSE
10323,35,29,64,19,20,1,FALSE
10324,47,18,183,11,84,73,FALSE
10325,82,10,107,12,32,20,FALSE
10326,88,4,93,3,91,88,FALSE
10327,146,8,220,6,49,43,FALSE
10328,50,20,192,13,34,21,FALSE
10329,194,15,142,19,44,25,FALSE
10330,143,20,257,3,62,59,FALSE
10331,120,1,169,10,41,31,FALSE
10332,38,28,156,19,97,78,FALSE
10333,69,27,171,12,21,9,FALSE
10334,164,4,138,11,24,13,FALSE
10335,149,8,282,2,66,64,FALSE
10336,174,20,179,12,55,43,FALSE
10337,51,30,163,10,40,30,FALSE
10338,48,14,61,9,84,75,FALSE
10339,183,21,31,9,46,37,FALSE
10340,161,23,89,4,86,82,FALSE
10341,165,4,213,10,48,38,FALSE
10342,140,16,82,18,70,52,FALSE
10343,67,3,63,5,37,32,FALSE
10344,69,28,184,4,75,71,FALSE
10345,50,23,195,3,29,26,FALSE
10346,39,5,39,15,83,68,FALSE
10347,179,24,189,15,20,5,True
10348,40,11,42,19,61,42,FALSE
10349,89,21,187,6,74,68,FALSE
10350,84,23,109,6,37,31,FALSE
10351,190,6,52,13,65,52,FALSE
10352,98,9,264,11,52,41,FALSE
10353,195,4,285,11,34,23,FALSE
10354,188,13,93,5,32,27,FALSE
10355,185,6,263,8,34,26,FALSE
10356,85,19,199,10,73,63,FALSE
10357,159,19,152,2,70,68,FALSE
10358,155,4,191,20,65,45,FALSE
10359,85,12,289,9,42,33,FALSE
10360,117,22,55,1,59,58,FALSE
10361,124,19,290,4,72,68,FALSE
10362,50,26,151,13,78,65,FALSE
10363,193,6,157,5,56,51,FALSE
10364,163,18,276,7,68,61,FALSE
10365,200,23,176,18,85,67,FALSE
10366,109,24,151,13,75,62,FALSE
10367,132,1,84,19,53,34,FALSE
10368,76,19,176,17,99,82,FALSE
10369,24,25,232,7,99,92,FALSE
10370,78,17,227,2,85,83,FALSE
10371,27,14,237,17,41,24,FALSE
10372,84,1,242,14,24,10,FALSE
10373,100,18,233,10,37,27,FALSE
10374,166,7,124,20,28,8,FALSE
10375,135,7,24,6,72,66,FALSE
10376,112,5,198,7,22,15,FALSE
10377,87,13,95,16,22,6,FALSE
10378,50,23,174,15,25,10,FALSE
10379,109,6,50,10,95,85,FALSE
10380,34,20,245,17,99,82,FALSE
10381,106,9,52,2,94,92,FALSE
10382,31,26,86,6,37,31,FALSE
10383,191,22,109,4,27,23,FALSE
10384,173,17,215,20,78,58,FALSE
10385,130,15,261,5,98,93,FALSE
10386,131,10,225,15,48,33,FALSE
10387,82,19,243,3,65,62,FALSE
10388,187,25,195,15,69,54,FALSE
10389,65,6,272,11,69,58,FALSE
10390,22,23,279,1,86,85,FALSE
10391,199,29,258,17,43,26,FALSE
10392,173,3,195,10,39,29,FALSE
10393,166,4,257,10,80,70,FALSE
10394,105,18,87,1,63,62,FALSE
10395,72,19,83,4,47,43,FALSE
10396,78,7,120,3,86,83,FALSE
10397,118,6,218,10,43,33,FALSE
10398,102,24,204,6,87,81,FALSE
10399,30,17,255,13,40,27,FALSE
10400,89,9,85,10,46,36,FALSE
10401,200,8,221,20,40,20,FALSE
10402,124,3,74,5,64,59,FALSE
10403,61,28,160,3,42,39,FALSE
10404,144,26,212,14,65,51,FALSE
10405,175,14,276,5,21,16,FALSE
10406,126,4,113,5,57,52,FALSE
10407,90,3,182,10,54,44,FALSE
10408,171,15,45,12,22,10,FALSE
10409,115,8,81,4,70,66,FALSE
10410,58,26,244,19,94,75,FALSE
10411,80,24,269,8,51,43,FALSE
10412,118,5,130,14,79,65,FALSE
10413,35,3,69,12,74,62,FALSE
10414,95,21,294,6,48,42,FALSE
10415,33,10,225,16,38,22,FALSE
10416,50,13,265,3,44,41,FALSE
10417,194,15,186,4,39,35,FALSE
10418,151,22,285,9,75,66,FALSE
10419,29,15,253,2,29,27,FALSE
10420,48,25,268,17,94,77,FALSE
10421,96,22,30,11,95,84,FALSE
10422,195,22,252,14,72,58,FALSE
10423,159,15,221,6,60,54,FALSE
10424,79,8,173,13,83,70,FALSE
10425,159,25,168,18,54,36,FALSE
10426,152,11,216,17,51,34,FALSE
10427,127,5,107,1,40,39,FALSE
10428,146,20,199,6,73,67,FALSE
10429,103,26,226,6,31,25,FALSE
10430,44,1,237,10,82,72,FALSE
10431,97,7,188,10,83,73,FALSE
10432,173,16,266,19,96,77,FALSE
10433,75,9,227,18,90,72,FALSE
10434,106,22,290,8,60,52,FALSE
10435,150,8,226,5,91,86,FALSE
10436,97,5,239,13,59,46,FALSE
10437,116,15,231,2,84,82,FALSE
10438,99,11,66,5,67,62,FALSE
10439,101,13,123,9,59,50,FALSE
10440,100,22,69,1,48,47,FALSE
10441,182,28,57,17,47,30,FALSE
10442,33,28,287,19,69,50,FALSE
10443,197,5,250,8,92,84,FALSE
10444,88,12,75,13,71,58,FALSE
10445,159,20,230,5,59,54,FALSE
10446,29,15,71,1,22,21,FALSE
10447,26,22,162,11,49,38,FALSE
10448,30,25,78,9,91,82,FALSE
10449,23,12,24,20,25,5,FALSE
10450,151,7,125,3,26,23,FALSE
10451,136,24,294,10,37,27,FALSE
10452,114,1,260,16,33,17,True
10453,103,18,273,1,85,84,FALSE
10454,162,10,109,7,65,58,FALSE
10455,133,27,87,10,77,67,FALSE
10456,136,20,204,12,93,81,FALSE
10457,170,12,259,13,22,9,FALSE
10458,58,30,127,8,28,20,FALSE
10459,197,13,86,3,83,80,FALSE
10460,102,30,98,8,34,26,FALSE
10461,137,12,243,19,77,58,FALSE
10462,200,13,204,19,84,65,FALSE
10463,149,30,267,18,41,23,FALSE
10464,125,20,197,8,96,88,FALSE
10465,130,23,135,12,96,84,FALSE
10466,63,19,208,1,43,42,FALSE
10467,141,2,225,11,93,82,FALSE
10468,197,5,112,7,22,15,FALSE
10469,36,14,119,3,88,85,FALSE
10470,111,16,294,7,60,53,FALSE
10471,92,30,41,8,92,84,FALSE
10472,131,6,45,16,47,31,FALSE
10473,169,12,137,13,71,58,FALSE
10474,82,2,126,10,47,37,FALSE
10475,104,28,90,7,56,49,FALSE
10476,61,19,223,16,90,74,FALSE
10477,199,27,170,2,39,37,FALSE
10478,31,23,263,9,58,49,True
10479,101,17,31,10,38,28,FALSE
10480,128,27,62,2,77,75,FALSE
10481,190,28,23,5,40,35,FALSE
10482,117,23,186,6,38,32,FALSE
10483,93,1,130,20,36,16,FALSE
10484,44,23,297,14,94,80,FALSE
10485,41,26,216,17,50,33,FALSE
10486,194,5,136,11,35,24,FALSE
10487,173,5,273,14,100,86,FALSE
10488,112,27,197,14,67,53,FALSE
10489,37,22,185,19,42,23,True
10490,179,4,187,10,33,23,FALSE
10491,52,19,106,10,35,25,FALSE
10492,103,7,231,11,48,37,FALSE
10493,63,14,272,7,33,26,True
10494,155,11,58,5,37,32,FALSE
10495,188,10,254,20,92,72,FALSE
10496,112,26,129,8,36,28,FALSE
10497,73,30,271,10,65,55,FALSE
10498,131,29,91,8,35,27,FALSE
10499,107,15,56,19,79,60,FALSE
10500,128,9,170,5,70,65,FALSE
10501,198,23,166,1,81,80,FALSE
10502,51,6,67,13,72,59,FALSE
10503,146,27,203,7,97,90,FALSE
10504,199,29,77,1,54,53,FALSE
10505,171,6,137,11,63,52,FALSE
10506,124,3,47,1,20,19,FALSE
10507,94,3,152,3,79,76,FALSE
10508,189,9,168,13,63,50,FALSE
10509,126,28,29,18,26,8,FALSE
10510,181,11,296,15,43,28,FALSE
10511,184,28,269,15,86,71,FALSE
10512,175,25,111,16,49,33,FALSE
10513,194,30,140,18,72,54,FALSE
10514,30,17,295,17,76,59,FALSE
10515,67,20,214,17,50,33,FALSE
10516,105,14,286,15,69,54,FALSE
10517,27,14,217,14,45,31,FALSE
10518,109,28,33,20,30,10,FALSE
10519,195,6,211,11,58,47,FALSE
10520,130,18,274,1,31,30,True
10521,35,26,87,3,54,51,FALSE
10522,67,27,154,14,38,24,FALSE
10523,76,15,232,9,28,19,FALSE
10524,190,18,292,12,46,34,FALSE
10525,149,10,190,5,27,22,FALSE
10526,172,10,88,4,52,48,FALSE
10527,168,13,287,19,46,27,FALSE
10528,166,15,287,6,76,70,FALSE
10529,200,9,168,10,78,68,FALSE
10530,33,10,105,6,96,90,FALSE
10531,95,21,276,8,85,77,FALSE
10532,152,29,124,18,57,39,FALSE
10533,98,6,101,20,87,67,FALSE
10534,183,3,294,8,44,36,FALSE
10535,61,4,191,11,71,60,FALSE
10536,31,6,169,8,85,77,FALSE
10537,191,30,244,16,47,31,FALSE
10538,161,29,141,13,53,40,FALSE
10539,100,23,155,13,48,35,FALSE
10540,57,20,112,3,56,53,FALSE
10541,111,4,260,9,57,48,FALSE
10542,99,26,91,8,41,33,FALSE
10543,69,8,272,13,77,64,FALSE
10544,151,5,108,4,71,67,FALSE
10545,118,9,106,13,77,64,FALSE
10546,187,11,225,6,52,46,FALSE
10547,20,10,162,3,20,17,FALSE
10548,84,10,29,3,73,70,FALSE
10549,72,19,131,10,90,80,FALSE
10550,74,22,71,9,22,13,True
10551,180,27,31,2,51,49,FALSE
10552,148,7,232,16,52,36,FALSE
10553,148,4,37,17,63,46,FALSE
10554,113,2,98,13,85,72,FALSE
10555,188,23,44,10,60,50,FALSE
10556,166,23,34,9,89,80,FALSE
10557,63,20,294,8,40,32,FALSE
10558,59,26,205,16,40,24,FALSE
10559,159,19,243,8,67,59,FALSE
10560,80,1,144,4,29,25,FALSE
10561,81,3,211,10,60,50,FALSE
10562,56,23,207,8,85,77,FALSE
10563,95,9,178,20,50,30,FALSE
10564,135,25,200,16,42,26,FALSE
10565,121,2,209,18,64,46,FALSE
10566,69,4,78,11,44,33,FALSE
10567,23,8,199,3,36,33,FALSE
10568,196,18,145,15,51,36,FALSE
10569,69,3,83,5,65,60,FALSE
10570,39,17,286,13,66,53,FALSE
10571,175,2,288,1,53,52,FALSE
10572,115,29,128,6,37,31,FALSE
10573,165,18,103,19,76,57,FALSE
10574,99,4,89,15,46,31,FALSE
10575,69,8,192,11,55,44,FALSE
10576,194,1,212,6,87,81,FALSE
10577,155,13,122,17,41,24,FALSE
10578,121,29,40,1,43,42,FALSE
10579,158,28,101,18,87,69,FALSE
10580,56,4,263,12,91,79,FALSE
10581,51,16,253,7,23,16,FALSE
10582,190,7,84,15,92,77,True
10583,68,22,47,3,45,42,FALSE
10584,30,16,199,3,48,45,FALSE
10585,108,14,122,13,34,21,FALSE
10586,162,7,278,15,46,31,FALSE
10587,73,15,218,1,87,86,FALSE
10588,50,17,103,1,100,99,FALSE
10589,79,12,231,10,67,57,FALSE
10590,76,25,136,5,89,84,FALSE
10591,28,7,32,20,34,14,FALSE
10592,83,28,283,16,78,62,FALSE
10593,199,20,256,5,62,57,FALSE
10594,78,22,108,10,93,83,FALSE
10595,61,11,161,8,63,55,FALSE
10596,63,6,97,6,49,43,FALSE
10597,176,12,213,4,63,59,FALSE
10598,72,6,94,12,22,10,FALSE
10599,68,13,139,6,36,30,FALSE
10600,109,11,200,18,94,76,FALSE
10601,171,17,99,7,41,34,FALSE
10602,172,12,192,7,52,45,FALSE
10603,115,9,159,13,48,35,FALSE
10604,79,17,49,2,65,63,FALSE
10605,180,21,63,3,54,51,FALSE
10606,33,3,214,6,94,88,FALSE
10607,75,13,278,2,39,37,FALSE
10608,121,27,92,3,35,32,FALSE
10609,185,2,218,20,66,46,FALSE
10610,102,25,228,15,42,27,FALSE
10611,156,5,118,11,68,57,FALSE
10612,104,3,113,19,27,8,FALSE
10613,72,7,100,11,22,11,FALSE
10614,114,14,204,10,81,71,FALSE
10615,46,7,53,18,80,62,FALSE
10616,23,21,243,4,89,85,FALSE
10617,197,26,28,15,41,26,FALSE
10618,162,14,235,16,50,34,FALSE
10619,189,1,240,17,64,47,FALSE
10620,43,22,144,18,21,3,FALSE
10621,137,2,242,19,59,40,FALSE
10622,70,24,257,2,49,47,FALSE
10623,55,7,233,8,51,43,FALSE
10624,104,4,129,4,56,52,FALSE
10625,188,2,293,6,64,58,FALSE
10626,102,14,143,8,79,71,FALSE
10627,155,13,234,4,53,49,FALSE
10628,63,21,273,20,87,67,FALSE
10629,177,20,183,3,61,58,FALSE
10630,193,20,136,13,65,52,FALSE
10631,124,23,223,6,64,58,FALSE
10632,73,7,121,1,54,53,FALSE
10633,140,15,189,12,60,48,FALSE
10634,128,29,81,20,59,39,FALSE
10635,32,10,51,10,21,11,FALSE
10636,94,13,282,9,94,85,FALSE
10637,200,2,241,4,73,69,FALSE
10638,176,27,39,1,55,54,FALSE
10639,113,14,280,19,28,9,FALSE
10640,75,11,204,15,75,60,FALSE
10641,115,22,244,15,76,61,FALSE
10642,141,6,223,10,53,43,FALSE
10643,54,7,66,8,98,90,FALSE
10644,96,14,234,3,24,21,FALSE
10645,170,28,55,5,97,92,FALSE
10646,182,17,271,12,55,43,FALSE
10647,172,25,77,17,92,75,FALSE
10648,193,9,41,9,83,74,FALSE
10649,112,15,106,2,31,29,FALSE
10650,139,30,215,7,31,24,FALSE
10651,93,30,120,9,77,68,FALSE
10652,175,4,69,14,77,63,FALSE
10653,53,9,241,1,46,45,FALSE
10654,114,20,237,17,30,13,FALSE
10655,160,23,271,8,91,83,FALSE
10656,172,8,237,20,43,23,FALSE
10657,189,11,52,14,59,45,FALSE
10658,96,21,250,13,20,7,FALSE
10659,132,26,275,19,80,61,FALSE
10660,102,6,204,2,27,25,FALSE
10661,30,11,121,9,79,70,FALSE
10662,33,17,101,14,39,25,FALSE
10663,108,20,222,20,98,78,FALSE
10664,106,25,256,18,90,72,FALSE
10665,43,8,107,5,21,16,FALSE
10666,164,1,30,19,45,26,FALSE
10667,64,10,293,16,97,81,FALSE
10668,132,26,151,13,38,25,FALSE
10669,190,16,144,3,89,86,FALSE
10670,160,2,138,5,25,20,FALSE
10671,35,6,56,8,91,83,FALSE
10672,125,14,35,9,97,88,FALSE
10673,86,9,219,12,95,83,FALSE
10674,135,5,87,9,48,39,FALSE
10675,126,27,283,18,74,56,FALSE
10676,39,24,120,2,64,62,FALSE
10677,40,10,280,15,86,71,FALSE
10678,34,1,152,9,73,64,FALSE
10679,27,6,90,14,74,60,FALSE
10680,89,5,33,3,34,31,FALSE
10681,44,15,261,13,100,87,FALSE
10682,25,10,125,1,37,36,FALSE
10683,82,18,221,19,99,80,FALSE
10684,174,2,256,6,78,72,FALSE
10685,125,17,71,15,39,24,True
10686,94,25,296,15,34,19,FALSE
10687,67,11,43,5,68,63,FALSE
10688,132,23,157,12,88,76,FALSE
10689,91,24,82,6,64,58,FALSE
10690,69,10,136,17,77,60,FALSE
10691,31,16,82,3,67,64,True
10692,101,30,86,4,72,68,FALSE
10693,28,9,170,15,60,45,FALSE
10694,76,18,203,7,44,37,FALSE
10695,57,23,184,11,73,62,FALSE
10696,76,8,35,12,26,14,FALSE
10697,112,12,208,2,45,43,FALSE
10698,88,13,234,10,68,58,True
10699,136,19,128,20,100,80,FALSE
10700,155,17,251,16,22,6,FALSE
10701,38,19,248,5,45,40,FALSE
10702,126,6,144,2,85,83,FALSE
10703,170,18,244,8,89,81,FALSE
10704,107,27,87,6,65,59,FALSE
10705,187,5,178,6,77,71,FALSE
10706,54,8,290,10,98,88,FALSE
10707,52,18,129,11,88,77,FALSE
10708,121,29,268,7,84,77,FALSE
10709,94,11,268,14,78,64,FALSE
10710,194,2,130,15,55,40,FALSE
10711,59,13,66,17,22,5,FALSE
10712,83,18,109,3,96,93,FALSE
10713,168,16,27,18,54,36,FALSE
10714,89,15,245,20,66,46,FALSE
10715,155,1,20,18,85,67,FALSE
10716,110,27,157,2,44,42,FALSE
10717,156,4,127,17,28,11,FALSE
10718,74,2,274,15,82,67,FALSE
10719,66,23,200,9,87,78,FALSE
10720,138,17,24,17,39,22,FALSE
10721,74,22,95,15,70,55,FALSE
10722,187,20,85,20,52,32,FALSE
10723,200,19,56,7,47,40,FALSE
10724,88,6,80,7,28,21,FALSE
10725,25,23,56,18,22,4,FALSE
10726,111,4,137,12,91,79,FALSE
10727,134,25,109,10,36,26,FALSE
10728,68,25,203,8,94,86,FALSE
10729,171,18,300,18,87,69,FALSE
10730,157,22,206,20,92,72,FALSE
10731,119,28,29,13,25,12,FALSE
10732,151,24,96,13,84,71,FALSE
10733,137,7,265,1,86,85,FALSE
10734,117,23,241,2,77,75,FALSE
10735,22,4,194,18,53,35,FALSE
10736,39,23,261,14,56,42,FALSE
10737,23,14,96,3,68,65,FALSE
10738,168,4,163,8,51,43,FALSE
10739,137,29,248,12,77,65,FALSE
10740,78,3,192,11,29,18,FALSE
10741,199,2,135,19,41,22,FALSE
10742,59,4,242,10,67,57,FALSE
10743,66,24,108,20,57,37,FALSE
10744,29,23,59,19,61,42,FALSE
10745,189,8,128,17,48,31,FALSE
10746,136,16,53,1,85,84,FALSE
10747,113,18,38,13,90,77,FALSE
10748,175,29,40,1,42,41,FALSE
10749,158,13,71,10,91,81,FALSE
10750,158,7,180,15,52,37,FALSE
10751,189,25,259,11,64,53,FALSE
10752,100,18,248,17,35,18,FALSE
10753,117,8,188,13,21,8,FALSE
10754,35,22,142,5,82,77,FALSE
10755,90,22,264,1,100,99,FALSE
10756,35,16,187,6,55,49,FALSE
10757,95,5,278,4,65,61,FALSE
10758,59,8,274,17,38,21,FALSE
10759,125,4,254,17,77,60,FALSE
10760,67,9,73,19,77,58,FALSE
10761,196,22,249,8,58,50,FALSE
10762,31,21,20,10,58,48,FALSE
10763,49,20,154,1,39,38,FALSE
10764,21,29,46,15,59,44,FALSE
10765,29,10,278,6,68,62,FALSE
10766,49,3,205,5,55,50,FALSE
10767,91,10,189,8,20,12,True
10768,45,14,294,14,76,62,FALSE
10769,151,21,162,19,70,51,FALSE
10770,61,15,66,2,27,25,FALSE
10771,42,20,126,7,52,45,FALSE
10772,45,26,157,7,80,73,FALSE
10773,95,26,29,6,47,41,FALSE
10774,111,28,245,2,70,68,FALSE
10775,75,17,88,15,86,71,FALSE
10776,156,17,88,1,100,99,True
10777,188,7,165,14,26,12,FALSE
10778,200,12,198,9,74,65,FALSE
10779,61,11,189,19,81,62,FALSE
10780,151,17,296,16,37,21,FALSE
10781,187,9,153,18,22,4,FALSE
10782,38,25,246,6,89,83,FALSE
10783,153,22,155,6,22,16,FALSE
10784,79,9,155,4,50,46,FALSE
10785,90,21,167,13,51,38,FALSE
10786,91,23,213,14,58,44,FALSE
10787,170,7,140,6,71,65,FALSE
10788,105,4,196,20,59,39,FALSE
10789,166,22,292,14,68,54,FALSE
10790,119,16,118,5,31,26,FALSE
10791,81,23,102,10,40,30,FALSE
10792,54,3,188,14,91,77,FALSE
10793,194,16,97,9,45,36,FALSE
10794,126,13,220,11,55,44,FALSE
10795,194,24,268,13,29,16,FALSE
10796,72,6,221,14,52,38,FALSE
10797,167,6,276,11,49,38,FALSE
10798,100,27,196,20,23,3,FALSE
10799,122,21,79,11,55,44,FALSE
10800,145,22,253,16,59,43,FALSE
10801,106,13,281,17,86,69,FALSE
10802,36,15,267,5,52,47,FALSE
10803,91,7,212,12,32,20,FALSE
10804,196,4,182,13,25,12,FALSE
10805,37,28,167,12,22,10,FALSE
10806,180,13,220,18,88,70,FALSE
10807,190,7,195,1,44,43,FALSE
10808,186,11,280,5,50,45,FALSE
10809,77,1,36,9,78,69,FALSE
10810,22,27,57,12,81,69,FALSE
10811,52,22,161,8,94,86,FALSE
10812,183,15,238,7,92,85,FALSE
10813,51,2,67,2,53,51,FALSE
10814,32,30,216,1,76,75,FALSE
10815,73,13,172,5,74,69,FALSE
10816,191,5,63,20,22,2,FALSE
10817,76,18,67,9,89,80,FALSE
10818,168,7,236,14,31,17,FALSE
10819,94,26,220,15,36,21,FALSE
10820,38,21,262,4,79,75,FALSE
10821,44,21,118,6,68,62,FALSE
10822,58,15,211,7,79,72,FALSE
10823,85,18,211,4,61,57,FALSE
10824,141,29,269,12,92,80,FALSE
10825,127,5,249,14,69,55,FALSE
10826,109,8,107,18,32,14,FALSE
10827,90,15,24,3,44,41,FALSE
10828,87,15,41,16,37,21,FALSE
10829,103,26,28,4,84,80,FALSE
10830,52,15,221,14,20,6,FALSE
10831,112,17,235,9,40,31,FALSE
10832,87,8,262,13,47,34,FALSE
10833,112,10,205,14,23,9,FALSE
10834,35,27,155,1,28,27,FALSE
10835,87,10,174,5,70,65,FALSE
10836,57,20,227,16,93,77,FALSE
10837,36,25,97,7,88,81,FALSE
10838,116,13,113,18,72,54,FALSE
10839,115,24,150,6,84,78,FALSE
10840,125,13,135,15,32,17,FALSE
10841,177,13,293,7,79,72,FALSE
10842,193,30,135,7,62,55,FALSE
10843,142,27,150,13,89,76,FALSE
10844,155,16,70,8,98,90,FALSE
10845,141,9,136,11,34,23,FALSE
10846,181,20,98,4,90,86,FALSE
10847,136,12,113,20,32,12,FALSE
10848,191,2,66,18,88,70,FALSE
10849,193,22,179,7,58,51,FALSE
10850,78,25,140,7,79,72,FALSE
10851,165,20,295,2,60,58,FALSE
10852,31,4,148,16,43,27,FALSE
10853,37,17,69,7,79,72,FALSE
10854,167,29,165,19,48,29,FALSE
10855,77,8,202,3,77,74,FALSE
10856,31,22,53,18,56,38,FALSE
10857,59,9,39,12,23,11,FALSE
10858,167,14,40,3,81,78,FALSE
10859,154,19,153,6,44,38,FALSE
10860,88,27,90,14,46,32,FALSE
10861,158,15,156,19,30,11,True
10862,126,30,218,3,56,53,FALSE
10863,97,19,46,15,65,50,FALSE
10864,125,4,24,17,68,51,FALSE
10865,104,12,297,5,97,92,FALSE
10866,53,4,66,5,57,52,FALSE
10867,167,10,44,8,65,57,FALSE
10868,45,9,181,7,41,34,FALSE
10869,49,18,279,2,32,30,FALSE
10870,137,28,205,13,32,19,FALSE
10871,173,15,180,20,50,30,FALSE
10872,200,8,133,18,23,5,FALSE
10873,31,6,48,13,90,77,FALSE
10874,94,12,39,4,66,62,FALSE
10875,123,18,261,16,64,48,FALSE
10876,198,10,111,13,20,7,FALSE
10877,143,2,24,1,30,29,FALSE
10878,113,29,155,7,69,62,True
10879,139,13,209,12,76,64,FALSE
10880,184,8,282,13,100,87,FALSE
10881,101,26,27,8,92,84,FALSE
10882,157,27,157,18,28,10,FALSE
10883,129,30,163,10,54,44,FALSE
10884,28,28,231,15,36,21,FALSE
10885,171,18,255,7,20,13,FALSE
10886,100,29,142,2,87,85,FALSE
10887,81,9,184,11,77,66,FALSE
10888,154,15,195,8,88,80,FALSE
10889,179,6,26,4,35,31,FALSE
10890,132,18,143,16,33,17,FALSE
10891,85,26,73,12,61,49,FALSE
10892,45,29,108,12,56,44,FALSE
10893,66,17,189,6,29,23,FALSE
10894,55,5,225,15,82,67,FALSE
10895,161,15,137,4,93,89,FALSE
10896,45,21,86,15,33,18,FALSE
10897,77,18,123,5,55,50,FALSE
10898,49,2,83,8,48,40,FALSE
10899,78,29,293,5,73,68,FALSE
10900,149,2,190,17,27,10,FALSE
10901,34,23,87,9,94,85,FALSE
10902,136,7,226,10,22,12,FALSE
10903,200,18,93,13,29,16,FALSE
10904,114,10,293,17,29,12,FALSE
10905,168,24,282,14,39,25,FALSE
10906,33,8,178,2,29,27,FALSE
10907,27,7,262,9,35,26,FALSE
10908,152,16,96,13,64,51,FALSE
10909,144,18,59,1,37,36,FALSE
10910,33,3,115,6,71,65,FALSE
10911,153,30,153,5,81,76,FALSE
10912,122,6,58,6,67,61,FALSE
10913,181,25,218,18,46,28,FALSE
10914,24,27,80,17,81,64,FALSE
10915,192,27,168,9,63,54,FALSE
10916,155,11,36,16,96,80,FALSE
10917,181,23,165,2,66,64,FALSE
10918,101,17,157,8,95,87,FALSE
10919,111,24,291,19,62,43,FALSE
10920,126,25,151,15,74,59,FALSE
10921,131,10,141,10,41,31,FALSE
10922,116,21,217,7,26,19,True
10923,25,18,64,13,70,57,FALSE
10924,180,17,153,12,53,41,FALSE
10925,193,20,55,8,26,18,FALSE
10926,192,21,46,8,47,39,FALSE
10927,136,12,161,8,66,58,FALSE
10928,31,30,96,14,56,42,FALSE
10929,110,19,199,4,24,20,FALSE
10930,90,7,30,12,76,64,FALSE
10931,117,8,30,17,79,62,FALSE
10932,113,26,219,1,65,64,FALSE
10933,50,27,93,3,72,69,FALSE
10934,126,28,247,20,63,43,FALSE
10935,109,19,106,14,25,11,FALSE
10936,158,29,191,10,100,90,FALSE
10937,98,16,205,5,74,69,FALSE
10938,183,10,159,19,77,58,FALSE
10939,133,3,242,17,26,9,FALSE
10940,165,6,224,12,78,66,FALSE
10941,154,28,91,19,43,24,FALSE
10942,143,1,144,13,59,46,FALSE
10943,156,22,150,20,85,65,FALSE
10944,66,28,48,7,34,27,FALSE
10945,45,3,154,18,73,55,FALSE
10946,106,11,273,6,97,91,FALSE
10947,88,23,133,18,77,59,FALSE
10948,98,13,226,20,32,12,True
10949,78,19,284,14,46,32,FALSE
10950,118,8,291,15,25,10,FALSE
10951,132,30,278,17,92,75,FALSE
10952,160,13,64,6,82,76,FALSE
10953,25,28,157,11,31,20,FALSE
10954,94,7,276,2,53,51,FALSE
10955,131,21,140,7,30,23,FALSE
10956,45,24,145,3,39,36,FALSE
10957,83,5,243,3,52,49,FALSE
10958,131,28,114,18,64,46,FALSE
10959,64,10,35,1,100,99,FALSE
10960,142,25,215,12,73,61,FALSE
10961,74,25,155,12,91,79,FALSE
10962,176,14,100,2,35,33,FALSE
10963,134,27,28,11,21,10,FALSE
10964,194,9,244,6,45,39,FALSE
10965,38,8,204,13,66,53,FALSE
10966,180,12,218,17,99,82,FALSE
10967,140,23,61,20,72,52,FALSE
10968,193,21,184,20,57,37,FALSE
10969,163,28,143,17,48,31,FALSE
10970,93,3,64,5,42,37,FALSE
10971,112,28,225,16,90,74,FALSE
10972,64,9,34,14,85,71,FALSE
10973,36,24,108,19,30,11,FALSE
10974,89,26,197,18,37,19,FALSE
10975,66,26,84,6,56,50,FALSE
10976,130,13,148,16,77,61,FALSE
10977,172,8,25,20,94,74,FALSE
10978,122,29,229,19,22,3,FALSE
10979,176,5,31,9,38,29,FALSE
10980,166,15,156,2,76,74,FALSE
10981,52,27,129,8,80,72,FALSE
10982,30,12,130,1,41,40,FALSE
10983,57,18,38,18,38,20,FALSE
10984,158,1,195,18,45,27,FALSE
10985,48,4,222,10,63,53,FALSE
10986,77,20,33,8,93,85,FALSE
10987,22,23,117,12,31,19,True
10988,186,9,37,18,59,41,FALSE
10989,139,20,63,10,28,18,FALSE
10990,83,18,183,17,28,11,FALSE
10991,163,14,121,16,63,47,FALSE
10992,185,18,69,13,38,25,FALSE
10993,116,17,63,11,65,54,FALSE
10994,105,12,147,9,33,24,FALSE
10995,22,17,216,1,91,90,FALSE
10996,170,18,233,2,37,35,FALSE
10997,195,22,123,8,33,25,FALSE
10998,58,10,154,8,36,28,FALSE
10999,74,9,122,8,26,18,FALSE
11000,130,19,169,4,40,36,FALSE
11001,172,7,290,19,74,55,FALSE
11002,67,14,111,18,49,31,FALSE
11003,35,24,135,14,95,81,FALSE
11004,43,23,165,7,40,33,FALSE
11005,24,3,83,17,79,62,FALSE
11006,98,7,284,16,46,30,True
11007,179,16,156,19,83,64,FALSE
11008,111,23,32,10,64,54,FALSE
11009,143,4,67,12,97,85,FALSE
11010,154,27,284,4,93,89,FALSE
11011,65,26,187,18,20,2,FALSE
11012,46,26,280,7,91,84,FALSE
11013,51,21,282,19,96,77,FALSE
11014,119,2,248,5,52,47,FALSE
11015,158,20,191,17,83,66,FALSE
11016,124,8,138,19,46,27,FALSE
11017,114,2,62,3,64,61,FALSE
11018,157,29,143,4,21,17,FALSE
11019,72,15,31,2,62,60,FALSE
11020,43,21,59,17,84,67,True
11021,72,26,194,20,82,62,FALSE
11022,132,26,45,4,63,59,FALSE
11023,118,18,73,5,56,51,FALSE
11024,182,3,23,4,65,61,FALSE
11025,90,23,153,5,71,66,FALSE
11026,115,18,172,15,88,73,FALSE
11027,79,25,40,13,73,60,FALSE
11028,194,1,199,19,33,14,FALSE
11029,125,30,157,1,83,82,FALSE
11030,145,19,101,7,55,48,FALSE
11031,107,24,121,10,38,28,FALSE
11032,90,6,102,6,24,18,FALSE
11033,70,8,77,11,50,39,FALSE
11034,47,12,102,7,68,61,FALSE
11035,146,29,103,8,30,22,FALSE
11036,130,10,241,4,90,86,FALSE
11037,24,7,161,7,86,79,FALSE
11038,162,28,249,15,87,72,FALSE
11039,34,20,186,1,100,99,FALSE
11040,70,17,39,14,93,79,FALSE
11041,184,19,165,4,46,42,FALSE
11042,134,14,33,16,96,80,FALSE
11043,163,12,123,5,27,22,FALSE
11044,129,18,131,6,20,14,FALSE
11045,126,17,292,4,23,19,FALSE
11046,125,24,103,18,70,52,FALSE
11047,69,11,203,3,22,19,FALSE
11048,73,7,75,2,41,39,FALSE
11049,108,8,225,10,50,40,FALSE
11050,41,21,140,16,20,4,FALSE
11051,36,13,65,11,28,17,FALSE
11052,63,9,198,12,80,68,FALSE
11053,130,24,246,12,75,63,FALSE
11054,73,22,47,14,100,86,FALSE
11055,42,28,283,7,23,16,FALSE
11056,159,24,276,2,23,21,FALSE
11057,132,18,27,8,20,12,FALSE
11058,119,24,37,5,79,74,FALSE
11059,139,28,26,10,86,76,FALSE
11060,65,12,41,12,42,30,FALSE
11061,198,29,130,10,75,65,FALSE
11062,84,20,173,16,56,40,FALSE
11063,160,30,116,19,69,50,FALSE
11064,63,30,24,3,88,85,FALSE
11065,114,18,156,17,89,72,FALSE
11066,175,3,72,18,57,39,FALSE
11067,148,11,293,11,76,65,FALSE
11068,57,5,211,13,41,28,FALSE
11069,34,26,88,11,68,57,FALSE
11070,171,29,175,11,80,69,FALSE
11071,26,20,111,15,34,19,FALSE
11072,48,26,161,16,50,34,FALSE
11073,42,14,93,19,64,45,FALSE
11074,94,24,183,4,98,94,FALSE
11075,22,11,20,11,53,42,FALSE
11076,177,28,21,11,26,15,FALSE
11077,103,14,285,12,76,64,FALSE
11078,165,7,213,7,30,23,FALSE
11079,191,20,246,16,50,34,FALSE
11080,173,29,138,12,20,8,FALSE
11081,170,20,293,14,42,28,FALSE
11082,92,29,106,16,46,30,FALSE
11083,75,21,266,20,48,28,FALSE
11084,57,6,294,16,93,77,FALSE
11085,184,4,45,17,39,22,FALSE
11086,28,15,269,20,41,21,FALSE
11087,34,12,25,15,38,23,FALSE
11088,161,1,25,19,38,19,FALSE
11089,187,20,198,17,87,70,FALSE
11090,73,7,92,2,45,43,FALSE
11091,21,6,39,7,41,34,True
11092,178,27,298,9,41,32,FALSE
11093,78,15,51,2,34,32,FALSE
11094,163,14,102,7,88,81,FALSE
11095,119,11,165,9,77,68,FALSE
11096,165,5,152,4,54,50,FALSE
11097,183,25,229,10,86,76,FALSE
11098,126,7,160,9,43,34,FALSE
11099,160,2,229,19,59,40,FALSE
11100,84,10,64,8,64,56,FALSE
11101,82,1,105,10,83,73,FALSE
11102,95,20,300,10,76,66,FALSE
11103,179,27,272,14,58,44,FALSE
11104,195,4,224,15,90,75,FALSE
11105,69,20,104,11,54,43,FALSE
11106,105,6,269,16,69,53,FALSE
11107,169,19,272,7,87,80,FALSE
11108,198,16,288,13,92,79,FALSE
11109,22,4,127,10,20,10,FALSE
11110,64,8,198,1,25,24,FALSE
11111,63,13,297,2,20,18,FALSE
11112,200,10,113,8,97,89,FALSE
11113,122,5,266,5,92,87,FALSE
11114,51,4,150,4,39,35,FALSE
11115,20,15,47,10,26,16,FALSE
11116,135,13,220,6,34,28,FALSE
11117,140,22,137,3,66,63,FALSE
11118,190,17,49,13,23,10,FALSE
11119,150,22,164,14,39,25,FALSE
11120,125,27,75,4,49,45,FALSE
11121,124,2,51,12,64,52,FALSE
11122,23,13,187,10,20,10,FALSE
11123,23,14,138,11,25,14,FALSE
11124,162,2,163,20,22,2,FALSE
11125,168,9,292,14,31,17,FALSE
11126,39,13,257,12,70,58,FALSE
11127,138,18,174,12,59,47,FALSE
11128,28,23,208,7,35,28,FALSE
11129,47,5,46,15,34,19,FALSE
11130,124,12,265,4,60,56,FALSE
11131,89,2,163,11,50,39,FALSE
11132,55,22,177,17,44,27,FALSE
11133,197,7,229,5,92,87,FALSE
11134,29,6,160,13,89,76,FALSE
11135,39,26,86,17,54,37,FALSE
11136,37,12,148,2,70,68,FALSE
11137,191,11,183,7,86,79,FALSE
11138,80,9,85,17,88,71,FALSE
11139,174,5,273,2,45,43,FALSE
11140,107,5,49,5,40,35,FALSE
11141,81,18,55,6,62,56,FALSE
11142,178,3,259,5,84,79,FALSE
11143,38,15,170,18,29,11,FALSE
11144,131,28,66,4,63,59,FALSE
11145,28,7,47,8,71,63,FALSE
11146,165,30,248,5,77,72,FALSE
11147,117,4,297,16,71,55,FALSE
11148,57,15,123,17,49,32,FALSE
11149,200,18,128,4,55,51,FALSE
11150,79,22,119,13,59,46,FALSE
11151,50,4,38,1,63,62,FALSE
11152,168,27,171,16,26,10,FALSE
11153,82,4,75,6,33,27,FALSE
11154,27,9,157,18,44,26,FALSE
11155,193,21,98,6,41,35,FALSE
11156,94,6,65,17,70,53,FALSE
11157,48,4,148,2,74,72,True
11158,37,8,212,18,29,11,FALSE
11159,69,19,98,14,36,22,FALSE
11160,42,13,214,13,38,25,FALSE
11161,33,9,180,1,25,24,FALSE
11162,190,2,66,18,29,11,FALSE
11163,136,9,263,2,97,95,FALSE
11164,130,4,57,11,81,70,FALSE
11165,69,2,167,1,81,80,FALSE
11166,101,3,52,8,24,16,FALSE
11167,73,8,157,17,62,45,FALSE
11168,138,29,267,14,73,59,FALSE
11169,177,5,219,15,62,47,FALSE
11170,162,21,70,3,85,82,FALSE
11171,28,15,80,2,60,58,FALSE
11172,147,22,233,18,57,39,FALSE
11173,75,28,257,16,73,57,FALSE
11174,96,27,192,11,47,36,FALSE
11175,108,10,167,3,40,37,FALSE
11176,56,21,193,2,83,81,FALSE
11177,70,2,114,18,61,43,FALSE
11178,184,12,150,16,61,45,FALSE
11179,22,30,210,14,29,15,FALSE
11180,83,3,181,13,98,85,FALSE
11181,101,3,175,3,53,50,FALSE
11182,193,5,300,16,97,81,FALSE
11183,141,4,26,11,29,18,FALSE
11184,194,7,68,10,53,43,FALSE
11185,132,1,248,4,83,79,FALSE
11186,104,5,100,12,40,28,FALSE
11187,188,5,132,16,23,7,FALSE
11188,143,25,104,17,48,31,FALSE
11189,191,7,123,8,26,18,FALSE
11190,143,1,184,4,99,95,FALSE
11191,30,22,206,17,51,34,FALSE
11192,120,13,237,4,62,58,FALSE
11193,116,14,78,15,45,30,FALSE
11194,153,13,221,2,60,58,FALSE
11195,75,30,157,16,60,44,FALSE
11196,117,17,230,8,39,31,FALSE
11197,200,25,145,15,40,25,FALSE
11198,64,13,33,2,35,33,FALSE
11199,22,13,246,5,26,21,FALSE
11200,198,3,36,13,47,34,FALSE
11201,147,13,239,14,55,41,FALSE
11202,72,25,67,9,90,81,FALSE
11203,116,11,186,12,57,45,FALSE
11204,102,11,228,13,30,17,FALSE
11205,157,12,245,4,35,31,FALSE
11206,98,15,171,8,26,18,FALSE
11207,39,24,120,11,21,10,FALSE
11208,132,10,175,17,46,29,FALSE
11209,116,16,24,12,24,12,True
11210,34,17,200,10,66,56,FALSE
11211,186,11,97,8,100,92,FALSE
11212,44,1,146,16,46,30,FALSE
11213,190,3,22,5,38,33,FALSE
11214,85,9,94,1,27,26,FALSE
11215,54,17,257,4,93,89,FALSE
11216,88,7,94,8,99,91,FALSE
11217,169,30,163,9,58,49,FALSE
11218,70,11,159,9,28,19,FALSE
11219,81,15,269,5,26,21,FALSE
11220,60,16,244,8,29,21,FALSE
11221,129,29,67,9,27,18,FALSE
11222,128,17,22,7,66,59,FALSE
11223,114,23,20,2,34,32,FALSE
11224,124,25,205,11,68,57,FALSE
11225,137,24,105,6,100,94,FALSE
11226,78,26,278,18,47,29,FALSE
11227,33,8,225,6,29,23,FALSE
11228,110,2,274,15,91,76,FALSE
11229,28,21,115,10,51,41,FALSE
11230,23,26,120,2,95,93,FALSE
11231,30,3,119,5,49,44,FALSE
11232,75,1,186,6,35,29,FALSE
11233,25,29,158,15,23,8,FALSE
11234,135,4,131,11,95,84,FALSE
11235,147,15,230,19,73,54,FALSE
11236,166,27,219,19,34,15,FALSE
11237,186,24,254,2,32,30,FALSE
11238,123,11,187,17,82,65,FALSE
11239,95,4,184,13,100,87,FALSE
11240,48,2,298,4,60,56,FALSE
11241,45,29,75,4,66,62,FALSE
11242,173,9,258,1,72,71,FALSE
11243,29,14,47,18,94,76,FALSE
11244,105,18,76,4,91,87,FALSE
11245,25,22,71,13,56,43,FALSE
11246,103,12,170,2,22,20,FALSE
11247,55,2,223,9,65,56,FALSE
11248,136,26,110,13,64,51,FALSE
11249,27,11,80,12,42,30,FALSE
11250,120,27,97,2,42,40,FALSE
11251,137,10,88,12,36,24,FALSE
11252,175,1,296,3,31,28,FALSE
11253,83,26,201,5,45,40,FALSE
11254,82,3,228,11,66,55,FALSE
11255,137,4,127,8,91,83,FALSE
11256,167,27,70,5,39,34,FALSE
11257,64,29,289,7,44,37,FALSE
11258,192,10,300,14,93,79,FALSE
11259,43,20,156,2,40,38,FALSE
11260,90,9,300,15,68,53,True
11261,66,25,163,18,61,43,FALSE
11262,112,3,274,4,66,62,True
11263,174,10,186,14,92,78,FALSE
11264,147,7,163,11,27,16,FALSE
11265,141,27,156,17,100,83,FALSE
11266,174,7,274,9,96,87,FALSE
11267,121,22,34,5,39,34,FALSE
11268,68,16,216,1,25,24,FALSE
11269,36,28,197,13,90,77,FALSE
11270,54,29,121,19,78,59,FALSE
11271,183,4,24,16,90,74,FALSE
11272,151,28,100,13,85,72,FALSE
11273,130,15,221,20,76,56,FALSE
11274,183,30,102,12,33,21,FALSE
11275,140,5,64,3,83,80,FALSE
11276,115,1,23,11,83,72,FALSE
11277,90,11,281,9,48,39,FALSE
11278,101,23,286,8,20,12,FALSE
11279,157,14,164,14,51,37,FALSE
11280,44,21,214,8,73,65,FALSE
11281,187,10,72,6,59,53,FALSE
11282,29,15,63,4,61,57,FALSE
11283,77,24,210,16,39,23,FALSE
11284,79,14,247,17,84,67,FALSE
11285,115,21,234,3,94,91,FALSE
11286,78,4,239,1,82,81,True
11287,163,8,130,1,74,73,True
11288,43,28,49,12,67,55,FALSE
11289,126,28,263,13,74,61,True
11290,131,8,36,6,64,58,FALSE
11291,182,18,110,16,46,30,FALSE
11292,118,26,239,4,39,35,FALSE
11293,123,27,139,15,90,75,FALSE
11294,44,18,178,1,35,34,FALSE
11295,52,22,241,19,25,6,FALSE
11296,75,27,144,10,63,53,FALSE
11297,47,24,286,1,31,30,FALSE
11298,83,21,289,16,84,68,FALSE
11299,80,14,143,3,62,59,FALSE
11300,31,19,286,11,49,38,FALSE
11301,121,11,84,19,49,30,FALSE
11302,42,4,170,12,38,26,FALSE
11303,122,25,22,18,88,70,FALSE
11304,100,29,199,5,66,61,FALSE
11305,187,14,197,3,21,18,FALSE
11306,117,1,173,10,47,37,FALSE
11307,179,9,274,19,21,2,FALSE
11308,86,3,65,15,76,61,FALSE
11309,121,13,254,20,28,8,FALSE
11310,184,1,80,3,25,22,FALSE
11311,171,22,257,20,68,48,FALSE
11312,173,3,123,19,76,57,FALSE
11313,172,15,90,6,41,35,FALSE
11314,191,23,24,16,46,30,FALSE
11315,28,26,203,5,36,31,FALSE
11316,70,27,105,9,81,72,FALSE
11317,51,29,248,15,70,55,FALSE
11318,79,17,152,20,37,17,FALSE
11319,163,4,44,1,77,76,True
11320,164,3,83,13,52,39,FALSE
11321,73,2,115,6,32,26,FALSE
11322,38,15,125,8,56,48,FALSE
11323,42,8,250,20,77,57,FALSE
11324,22,18,59,10,25,15,FALSE
11325,87,25,209,1,51,50,FALSE
11326,153,16,202,15,25,10,FALSE
11327,33,27,242,12,20,8,FALSE
11328,153,27,299,8,47,39,FALSE
11329,114,6,148,16,72,56,FALSE
11330,78,25,197,8,47,39,FALSE
11331,76,2,187,18,81,63,True
11332,167,7,286,17,57,40,FALSE
11333,163,20,235,3,88,85,FALSE
11334,161,28,219,12,52,40,FALSE
11335,142,3,48,18,47,29,FALSE
11336,80,24,237,20,91,71,FALSE
11337,51,5,257,3,32,29,FALSE
11338,91,19,152,8,65,57,FALSE
11339,87,27,80,10,37,27,FALSE
11340,183,10,128,6,93,87,FALSE
11341,186,4,236,14,29,15,FALSE
11342,52,20,213,17,29,12,FALSE
11343,176,28,171,6,79,73,True
11344,105,17,21,7,27,20,FALSE
11345,68,5,94,12,51,39,FALSE
11346,177,21,114,10,78,68,FALSE
11347,63,6,212,7,67,60,FALSE
11348,110,6,90,13,51,38,FALSE
11349,163,18,239,7,90,83,FALSE
11350,54,2,273,18,60,42,FALSE
11351,85,11,68,9,50,41,FALSE
11352,177,21,215,11,67,56,FALSE
11353,129,16,192,6,20,14,FALSE
11354,90,20,284,20,69,49,FALSE
11355,41,14,78,7,91,84,FALSE
11356,38,6,42,11,55,44,FALSE
11357,38,27,59,6,71,65,FALSE
11358,123,28,198,6,46,40,FALSE
11359,33,30,36,18,72,54,FALSE
11360,171,15,141,11,53,42,FALSE
11361,81,4,44,3,54,51,FALSE
11362,96,20,207,9,73,64,FALSE
11363,190,29,129,13,30,17,FALSE
11364,81,2,232,13,67,54,FALSE
11365,172,18,155,5,70,65,FALSE
11366,93,19,123,4,99,95,FALSE
11367,164,25,245,19,89,70,FALSE
11368,88,15,279,16,76,60,FALSE
11369,80,23,31,5,100,95,FALSE
11370,94,13,131,5,20,15,FALSE
11371,63,5,197,17,92,75,FALSE
11372,28,1,165,8,69,61,FALSE
11373,189,24,227,9,78,69,FALSE
11374,20,27,217,16,39,23,FALSE
11375,124,22,88,9,56,47,FALSE
11376,150,10,74,3,82,79,FALSE
11377,96,12,259,1,46,45,True
11378,56,10,207,2,24,22,FALSE
11379,152,26,132,14,24,10,FALSE
11380,89,1,53,3,49,46,FALSE
11381,94,23,296,12,46,34,FALSE
11382,151,25,167,17,49,32,FALSE
11383,147,30,158,14,89,75,FALSE
11384,167,20,196,2,23,21,FALSE
11385,161,25,123,9,65,56,FALSE
11386,53,20,93,12,29,17,FALSE
11387,79,5,82,13,94,81,FALSE
11388,53,30,294,13,84,71,FALSE
11389,42,25,145,11,33,22,FALSE
11390,121,6,48,8,89,81,FALSE
11391,132,30,274,17,27,10,FALSE
11392,124,29,177,16,93,77,FALSE
11393,195,2,230,8,86,78,FALSE
11394,134,17,187,8,76,68,FALSE
11395,56,17,169,2,20,18,FALSE
11396,165,15,174,14,29,15,FALSE
11397,29,20,298,6,30,24,FALSE
11398,144,26,65,4,75,71,FALSE
11399,23,29,218,9,34,25,FALSE
11400,159,22,31,15,47,32,FALSE
11401,90,16,256,17,29,12,FALSE
11402,28,1,164,3,63,60,FALSE
11403,56,28,258,18,66,48,FALSE
11404,44,28,118,13,61,48,True
11405,139,28,277,1,23,22,FALSE
11406,84,21,57,2,32,30,FALSE
11407,28,23,114,20,59,39,FALSE
11408,181,13,299,4,95,91,FALSE
11409,52,18,123,1,63,62,FALSE
11410,124,25,118,6,42,36,FALSE
11411,160,1,256,19,47,28,FALSE
11412,144,6,92,20,70,50,FALSE
11413,184,9,287,9,65,56,FALSE
11414,187,5,36,5,67,62,FALSE
11415,97,13,222,16,89,73,FALSE
11416,97,5,283,9,73,64,FALSE
11417,172,20,164,7,49,42,FALSE
11418,165,14,130,19,68,49,FALSE
11419,37,23,76,8,30,22,FALSE
11420,153,9,38,16,85,69,FALSE
11421,175,11,206,13,98,85,FALSE
11422,162,21,281,6,54,48,FALSE
11423,157,16,33,2,39,37,FALSE
11424,73,24,270,3,65,62,FALSE
11425,33,5,243,19,63,44,FALSE
11426,99,17,42,12,22,10,FALSE
11427,49,22,166,3,58,55,FALSE
11428,27,13,145,13,23,10,FALSE
11429,193,30,234,1,46,45,FALSE
11430,115,9,137,10,67,57,FALSE
11431,103,7,246,11,80,69,FALSE
11432,95,29,94,7,28,21,FALSE
11433,135,11,80,20,68,48,FALSE
11434,153,3,179,14,80,66,FALSE
11435,200,13,150,11,29,18,FALSE
11436,129,27,230,14,71,57,FALSE
11437,101,7,299,6,32,26,FALSE
11438,130,4,85,16,23,7,FALSE
11439,25,20,38,16,85,69,FALSE
11440,148,19,222,19,21,2,FALSE
11441,56,13,52,9,21,12,FALSE
11442,143,19,166,16,47,31,FALSE
11443,62,26,20,12,43,31,FALSE
11444,107,6,107,8,52,44,FALSE
11445,114,27,171,2,21,19,FALSE
11446,90,28,197,19,100,81,FALSE
11447,132,13,108,2,79,77,FALSE
11448,188,20,135,4,71,67,FALSE
11449,115,1,86,12,61,49,FALSE
11450,63,5,89,11,22,11,FALSE
11451,148,6,156,13,25,12,FALSE
11452,133,13,74,17,90,73,FALSE
11453,40,1,84,16,45,29,FALSE
11454,64,25,234,7,31,24,FALSE
11455,36,18,123,13,65,52,FALSE
11456,42,20,32,10,44,34,FALSE
11457,96,14,261,9,85,76,FALSE
11458,62,9,168,16,93,77,FALSE
11459,175,10,246,2,23,21,FALSE
11460,52,11,175,12,78,66,FALSE
11461,105,10,272,13,34,21,FALSE
11462,43,10,271,7,92,85,FALSE
11463,29,25,43,1,46,45,FALSE
11464,149,4,197,7,38,31,FALSE
11465,75,14,58,11,98,87,FALSE
11466,132,4,236,5,56,51,FALSE
11467,27,1,286,19,43,24,FALSE
11468,181,23,32,14,53,39,FALSE
11469,198,1,221,17,58,41,FALSE
11470,178,27,216,3,68,65,FALSE
11471,115,28,284,20,36,16,FALSE
11472,92,29,289,1,95,94,FALSE
11473,83,19,257,17,28,11,FALSE
11474,70,28,111,13,93,80,FALSE
11475,36,26,201,6,48,42,FALSE
11476,96,27,280,3,76,73,FALSE
11477,147,27,114,15,36,21,True
11478,200,24,59,5,91,86,FALSE
11479,71,16,227,17,76,59,FALSE
11480,90,1,43,14,22,8,FALSE
11481,109,17,97,11,42,31,FALSE
11482,113,8,55,8,72,64,FALSE
11483,145,21,20,17,74,57,FALSE
11484,137,21,250,12,84,72,FALSE
11485,149,2,65,20,76,56,FALSE
11486,169,3,214,4,24,20,FALSE
11487,194,5,279,7,40,33,FALSE
11488,147,10,130,16,29,13,FALSE
11489,178,22,293,3,89,86,FALSE
11490,193,7,285,7,71,64,FALSE
11491,89,3,84,18,77,59,FALSE
11492,108,28,100,6,97,91,FALSE
11493,78,10,54,15,68,53,FALSE
11494,73,29,246,9,90,81,FALSE
11495,112,11,115,2,99,97,FALSE
11496,121,16,34,10,21,11,True
11497,84,9,158,3,57,54,FALSE
11498,110,15,289,2,36,34,FALSE
11499,80,18,272,3,65,62,FALSE
11500,132,26,199,19,100,81,FALSE
11501,104,26,224,11,56,45,FALSE
11502,137,7,21,9,36,27,FALSE
11503,125,14,130,10,91,81,FALSE
11504,20,9,258,18,60,42,FALSE
11505,75,11,145,2,62,60,FALSE
11506,105,13,133,14,40,26,FALSE
11507,46,10,118,3,28,25,FALSE
11508,51,25,210,9,93,84,FALSE
11509,40,7,96,14,34,20,FALSE
11510,174,24,280,10,64,54,FALSE
11511,188,23,275,15,49,34,FALSE
11512,81,3,242,9,61,52,FALSE
11513,161,3,151,16,99,83,FALSE
11514,69,3,163,14,45,31,FALSE
11515,78,9,57,3,77,74,FALSE
11516,84,29,93,6,78,72,FALSE
11517,91,24,156,4,33,29,FALSE
11518,125,20,79,19,26,7,FALSE
11519,183,4,85,13,69,56,FALSE
11520,42,3,294,9,33,24,FALSE
11521,139,8,271,8,60,52,FALSE
11522,24,24,31,19,21,2,FALSE
11523,64,21,210,14,30,16,FALSE
11524,110,15,278,5,35,30,FALSE
11525,147,9,31,11,58,47,FALSE
11526,198,8,42,20,24,4,FALSE
11527,131,8,101,11,30,19,FALSE
11528,129,20,165,19,42,23,FALSE
11529,122,22,93,15,60,45,FALSE
11530,30,10,27,17,37,20,FALSE
11531,135,22,168,20,35,15,FALSE
11532,21,6,267,6,87,81,FALSE
11533,46,11,193,4,48,44,FALSE
11534,140,25,293,16,68,52,FALSE
11535,89,29,203,8,65,57,FALSE
11536,191,11,191,14,42,28,FALSE
11537,109,28,285,20,78,58,FALSE
11538,65,8,194,9,59,50,FALSE
11539,199,29,247,11,36,25,FALSE
11540,56,9,87,9,73,64,True
11541,196,19,161,15,37,22,FALSE
11542,107,9,198,14,33,19,FALSE
11543,105,17,275,14,67,53,FALSE
11544,143,10,32,3,56,53,FALSE
11545,111,15,168,11,26,15,FALSE
11546,127,25,54,19,92,73,FALSE
11547,100,5,259,18,59,41,FALSE
11548,32,28,71,6,49,43,FALSE
11549,174,29,284,6,85,79,FALSE
11550,58,26,139,16,33,17,FALSE
11551,77,14,240,4,64,60,FALSE
11552,42,1,201,14,27,13,FALSE
11553,186,5,221,13,31,18,FALSE
11554,100,5,185,11,43,32,FALSE
11555,191,8,32,12,39,27,FALSE
11556,83,6,132,5,23,18,FALSE
11557,61,20,201,12,100,88,True
11558,43,23,262,18,80,62,FALSE
11559,147,5,265,8,22,14,True
11560,159,26,179,6,21,15,FALSE
11561,180,21,274,6,54,48,FALSE
11562,77,6,187,8,59,51,FALSE
11563,177,19,131,7,62,55,FALSE
11564,119,14,73,4,63,59,FALSE
11565,28,12,88,4,61,57,FALSE
11566,23,8,190,7,63,56,FALSE
11567,119,26,276,14,70,56,FALSE
11568,182,21,114,13,56,43,FALSE
11569,56,6,222,5,48,43,FALSE
11570,67,9,37,5,96,91,FALSE
11571,67,30,130,19,59,40,FALSE
11572,150,28,258,14,21,7,FALSE
11573,125,28,174,2,87,85,FALSE
11574,63,4,121,11,87,76,FALSE
11575,84,20,284,1,57,56,FALSE
11576,165,23,45,10,36,26,FALSE
11577,170,24,43,13,65,52,FALSE
11578,43,9,77,10,26,16,FALSE
11579,103,19,36,9,85,76,FALSE
11580,49,11,118,1,57,56,FALSE
11581,50,19,274,19,64,45,FALSE
11582,168,13,159,13,74,61,FALSE
11583,99,24,248,13,61,48,FALSE
11584,117,2,153,17,75,58,FALSE
11585,103,15,220,10,96,86,FALSE
11586,66,30,27,14,28,14,FALSE
11587,174,21,122,20,91,71,FALSE
11588,88,29,135,2,27,25,FALSE
11589,36,12,41,7,39,32,FALSE
11590,144,5,104,7,79,72,FALSE
11591,95,20,260,11,55,44,True
11592,24,22,21,13,45,32,FALSE
11593,20,21,32,10,62,52,FALSE
11594,87,19,276,11,31,20,FALSE
11595,160,25,133,5,67,62,FALSE
11596,185,23,140,6,91,85,FALSE
11597,192,12,108,12,77,65,FALSE
11598,120,17,59,10,92,82,FALSE
11599,147,10,218,8,66,58,FALSE
11600,165,7,298,10,28,18,FALSE
11601,200,29,291,16,31,15,FALSE
11602,172,16,87,4,94,90,FALSE
11603,33,13,281,6,50,44,FALSE
11604,188,19,290,8,86,78,FALSE
11605,44,28,206,13,95,82,FALSE
11606,21,29,30,13,98,85,FALSE
11607,189,26,172,13,69,56,FALSE
11608,199,5,99,10,70,60,FALSE
11609,52,17,292,6,64,58,FALSE
11610,93,14,39,19,48,29,FALSE
11611,144,1,79,2,29,27,FALSE
11612,138,29,197,4,56,52,FALSE
11613,90,30,190,17,32,15,FALSE
11614,180,12,114,3,23,20,FALSE
11615,110,1,109,18,64,46,FALSE
11616,24,23,134,20,77,57,FALSE
11617,157,6,145,20,36,16,FALSE
11618,47,17,111,12,89,77,FALSE
11619,69,25,98,8,94,86,FALSE
11620,23,3,208,14,88,74,FALSE
11621,112,4,191,3,24,21,FALSE
11622,193,13,167,18,36,18,FALSE
11623,151,13,206,14,57,43,FALSE
11624,85,26,263,4,62,58,FALSE
11625,52,28,118,3,37,34,FALSE
11626,82,2,34,14,27,13,FALSE
11627,171,15,28,15,91,76,FALSE
11628,44,5,168,8,34,26,FALSE
11629,135,30,71,11,81,70,FALSE
11630,106,29,133,17,93,76,FALSE
11631,78,20,178,16,88,72,FALSE
11632,64,23,222,3,76,73,FALSE
11633,85,1,143,4,95,91,FALSE
11634,70,26,187,5,65,60,FALSE
11635,160,12,239,2,57,55,FALSE
11636,110,14,77,20,46,26,FALSE
11637,160,7,151,18,41,23,FALSE
11638,46,26,41,18,92,74,FALSE
11639,38,9,31,17,75,58,FALSE
11640,27,19,202,4,91,87,FALSE
11641,142,12,230,14,31,17,FALSE
11642,98,22,268,3,40,37,FALSE
11643,167,7,73,4,99,95,FALSE
11644,193,26,84,4,52,48,FALSE
11645,94,27,174,20,60,40,FALSE
11646,119,21,177,4,74,70,FALSE
11647,57,6,114,12,74,62,FALSE
11648,195,22,65,12,20,8,FALSE
11649,68,27,47,8,27,19,FALSE
11650,94,3,41,4,39,35,FALSE
11651,168,11,214,11,55,44,True
11652,175,24,161,6,24,18,FALSE
11653,87,19,283,15,25,10,FALSE
11654,44,1,285,5,21,16,FALSE
11655,51,14,145,13,83,70,FALSE
11656,40,7,199,13,73,60,FALSE
11657,82,13,226,11,66,55,FALSE
11658,126,28,103,20,90,70,FALSE
11659,97,22,252,13,57,44,FALSE
11660,24,26,117,8,88,80,FALSE
11661,89,30,281,18,58,40,FALSE
11662,59,2,121,16,75,59,FALSE
11663,154,25,275,20,74,54,FALSE
11664,198,2,120,14,84,70,FALSE
11665,125,24,134,6,95,89,FALSE
11666,87,30,83,8,25,17,FALSE
11667,182,29,54,9,54,45,FALSE
11668,74,3,173,3,30,27,FALSE
11669,181,11,255,13,34,21,FALSE
11670,135,10,91,3,68,65,FALSE
11671,51,18,89,20,40,20,FALSE
11672,50,7,228,4,64,60,FALSE
11673,178,25,164,7,66,59,FALSE
11674,117,1,226,6,90,84,FALSE
11675,154,23,132,1,83,82,FALSE
11676,189,3,76,16,42,26,FALSE
11677,33,2,80,14,26,12,FALSE
11678,33,26,217,3,30,27,FALSE
11679,90,26,149,8,55,47,FALSE
11680,153,30,128,20,90,70,FALSE
11681,185,29,43,14,62,48,FALSE
11682,26,13,264,17,26,9,FALSE
11683,22,6,216,14,39,25,FALSE
11684,28,7,200,20,35,15,True
11685,55,27,199,11,26,15,FALSE
11686,42,13,228,16,32,16,FALSE
11687,88,15,140,13,25,12,FALSE
11688,95,6,219,7,29,22,FALSE
11689,92,14,225,20,25,5,FALSE
11690,51,8,257,2,82,80,FALSE
11691,61,11,64,12,40,28,FALSE
11692,170,5,248,15,39,24,FALSE
11693,146,9,210,18,81,63,FALSE
11694,123,1,288,19,25,6,FALSE
11695,118,10,76,11,53,42,FALSE
11696,169,23,81,13,24,11,FALSE
11697,185,1,270,9,45,36,FALSE
11698,51,25,260,9,30,21,FALSE
11699,92,3,164,16,31,15,FALSE
11700,88,6,230,13,41,28,FALSE
11701,140,11,25,1,65,64,FALSE
11702,122,6,257,7,97,90,FALSE
11703,22,25,145,15,78,63,FALSE
11704,45,26,223,18,85,67,FALSE
11705,146,12,279,1,63,62,FALSE
11706,104,15,272,3,64,61,FALSE
11707,131,6,61,3,71,68,FALSE
11708,56,21,69,1,47,46,FALSE
11709,117,30,21,2,87,85,FALSE
11710,133,27,200,16,59,43,FALSE
11711,199,14,191,8,85,77,FALSE
11712,32,1,38,5,69,64,FALSE
11713,177,2,271,7,52,45,FALSE
11714,47,23,268,11,48,37,FALSE
11715,41,7,236,2,69,67,FALSE
11716,173,20,103,6,37,31,FALSE
11717,70,27,294,9,67,58,FALSE
11718,128,24,197,20,51,31,FALSE
11719,162,25,158,4,66,62,FALSE
11720,200,10,50,5,63,58,FALSE
11721,171,13,70,1,63,62,FALSE
11722,128,2,215,10,41,31,FALSE
11723,182,25,68,12,70,58,FALSE
11724,50,10,97,14,76,62,FALSE
11725,74,14,61,5,22,17,FALSE
11726,29,7,73,4,65,61,FALSE
11727,32,5,109,17,94,77,FALSE
11728,137,30,51,9,56,47,FALSE
11729,192,28,56,9,22,13,FALSE
11730,29,21,41,10,69,59,FALSE
11731,43,29,213,3,28,25,FALSE
11732,56,11,32,4,71,67,FALSE
11733,178,10,24,6,21,15,FALSE
11734,159,7,25,14,96,82,FALSE
11735,93,2,181,3,76,73,FALSE
11736,137,18,222,14,24,10,FALSE
11737,137,1,152,12,86,74,FALSE
11738,147,4,132,18,99,81,FALSE
11739,32,17,90,11,68,57,FALSE
11740,141,15,127,13,90,77,FALSE
11741,184,27,141,19,26,7,FALSE
11742,62,16,108,5,20,15,FALSE
11743,59,29,35,18,42,24,FALSE
11744,169,15,64,6,58,52,FALSE
11745,123,22,76,16,97,81,FALSE
11746,141,25,229,7,63,56,FALSE
11747,64,29,66,1,50,49,FALSE
11748,116,23,145,10,66,56,FALSE
11749,48,4,262,18,75,57,FALSE
11750,74,3,268,10,48,38,FALSE
11751,144,12,300,20,28,8,FALSE
11752,53,2,146,12,100,88,FALSE
11753,120,20,55,4,53,49,FALSE
11754,156,16,258,5,61,56,FALSE
11755,194,8,38,12,34,22,FALSE
11756,52,28,59,12,93,81,FALSE
11757,88,6,161,12,91,79,FALSE
11758,117,3,140,16,74,58,FALSE
11759,67,7,86,19,49,30,FALSE
11760,159,26,198,2,81,79,FALSE
11761,76,11,105,7,86,79,FALSE
11762,190,8,255,6,59,53,FALSE
11763,118,8,192,9,98,89,FALSE
11764,42,5,35,13,66,53,FALSE
11765,194,15,83,20,50,30,FALSE
11766,165,20,150,17,47,30,FALSE
11767,148,26,212,12,58,46,FALSE
11768,194,2,131,10,73,63,FALSE
11769,70,16,30,11,33,22,FALSE
11770,36,1,246,18,47,29,True
11771,167,9,272,20,27,7,FALSE
11772,78,26,266,2,25,23,FALSE
11773,33,29,176,8,90,82,FALSE
11774,31,17,207,6,25,19,FALSE
11775,23,26,209,20,32,12,FALSE
11776,187,21,168,4,78,74,FALSE
11777,22,9,72,18,61,43,FALSE
11778,54,7,199,4,30,26,FALSE
11779,146,23,195,12,25,13,FALSE
11780,108,16,137,12,62,50,FALSE
11781,65,1,58,4,28,24,FALSE
11782,131,9,186,18,70,52,FALSE
11783,106,26,265,4,33,29,FALSE
11784,50,27,65,4,56,52,FALSE
11785,188,21,295,16,42,26,FALSE
11786,42,29,214,17,47,30,FALSE
11787,200,30,175,5,88,83,FALSE
11788,195,6,227,10,56,46,FALSE
11789,30,10,127,20,94,74,FALSE
11790,39,1,298,15,52,37,FALSE
11791,151,1,267,8,30,22,FALSE
11792,110,13,214,3,42,39,FALSE
11793,105,12,164,17,63,46,FALSE
11794,179,15,62,7,20,13,FALSE
11795,147,3,240,12,63,51,FALSE
11796,44,12,22,1,88,87,FALSE
11797,77,8,106,3,48,45,FALSE
11798,34,1,100,1,56,55,FALSE
11799,148,7,208,7,89,82,FALSE
11800,168,8,246,13,25,12,FALSE
11801,182,17,208,6,50,44,FALSE
11802,135,11,91,13,88,75,FALSE
11803,92,1,237,8,72,64,FALSE
11804,71,28,32,15,48,33,FALSE
11805,171,28,213,6,56,50,FALSE
11806,185,20,260,19,42,23,FALSE
11807,154,14,158,3,37,34,FALSE
11808,114,29,38,17,97,80,FALSE
11809,61,30,68,2,47,45,FALSE
11810,46,1,208,13,62,49,FALSE
11811,125,6,101,5,58,53,FALSE
11812,117,28,211,20,65,45,FALSE
11813,163,26,37,18,64,46,FALSE
11814,87,24,65,8,44,36,FALSE
11815,42,11,289,14,50,36,FALSE
11816,111,21,285,17,49,32,FALSE
11817,51,24,283,7,61,54,FALSE
11818,70,10,215,17,47,30,FALSE
11819,24,7,196,1,36,35,FALSE
11820,64,26,145,15,71,56,FALSE
11821,49,25,89,14,100,86,FALSE
11822,56,29,294,7,24,17,FALSE
11823,30,6,107,20,27,7,FALSE
11824,195,25,96,1,88,87,FALSE
11825,197,2,300,10,76,66,True
11826,165,23,48,10,33,23,FALSE
11827,104,28,237,14,85,71,FALSE
11828,168,19,60,15,73,58,FALSE
11829,169,21,109,6,63,57,FALSE
11830,84,13,62,14,45,31,FALSE
11831,160,23,76,15,35,20,FALSE
11832,119,10,154,14,20,6,FALSE
11833,111,19,195,7,76,69,FALSE
11834,136,8,236,9,62,53,FALSE
11835,62,7,135,12,83,71,True
11836,38,23,116,8,77,69,FALSE
11837,70,19,110,13,24,11,FALSE
11838,191,11,212,2,91,89,FALSE
11839,39,6,145,4,62,58,True
11840,109,18,52,16,81,65,FALSE
11841,37,14,143,1,92,91,FALSE
11842,58,17,148,2,99,97,FALSE
11843,135,19,266,20,53,33,FALSE
11844,128,10,279,2,41,39,FALSE
11845,25,21,45,12,43,31,FALSE
11846,185,13,47,2,75,73,FALSE
11847,195,3,179,4,29,25,FALSE
11848,183,9,158,17,72,55,FALSE
11849,183,17,197,14,49,35,FALSE
11850,123,26,110,17,34,17,FALSE
11851,53,27,166,18,23,5,FALSE
11852,69,6,37,12,65,53,FALSE
11853,52,9,280,8,59,51,FALSE
11854,194,21,113,10,41,31,FALSE
11855,91,25,46,13,24,11,FALSE
11856,58,21,155,9,21,12,FALSE
11857,163,14,192,18,40,22,True
11858,119,12,37,18,48,30,FALSE
11859,198,22,34,2,51,49,FALSE
11860,131,1,134,17,33,16,FALSE
11861,144,8,46,18,67,49,FALSE
11862,88,22,203,18,97,79,FALSE
11863,57,30,286,13,71,58,FALSE
11864,104,28,235,20,27,7,FALSE
11865,26,14,201,15,53,38,FALSE
11866,23,8,242,15,32,17,FALSE
11867,185,13,248,5,38,33,FALSE
11868,69,8,108,15,55,40,FALSE
11869,85,8,114,6,97,91,FALSE
11870,147,30,110,15,56,41,FALSE
11871,90,10,131,4,67,63,FALSE
11872,38,20,53,6,63,57,FALSE
11873,82,8,115,11,36,25,FALSE
11874,194,18,299,5,20,15,FALSE
11875,85,2,50,18,77,59,FALSE
11876,109,22,115,11,37,26,FALSE
11877,135,24,258,1,99,98,FALSE
11878,90,3,21,19,37,18,FALSE
11879,146,11,113,15,56,41,FALSE
11880,55,9,149,1,88,87,True
11881,195,29,34,19,30,11,FALSE
11882,40,30,72,13,45,32,FALSE
11883,135,28,291,11,31,20,True
11884,21,2,138,15,60,45,FALSE
11885,116,14,146,7,26,19,FALSE
11886,180,25,70,4,39,35,FALSE
11887,64,21,287,17,59,42,FALSE
11888,105,22,251,1,66,65,FALSE
11889,195,28,173,1,79,78,FALSE
11890,47,13,70,15,45,30,FALSE
11891,95,17,22,20,30,10,FALSE
11892,68,12,130,15,20,5,FALSE
11893,104,21,266,20,76,56,FALSE
11894,172,11,292,11,24,13,FALSE
11895,182,3,29,16,75,59,FALSE
11896,114,18,139,1,71,70,FALSE
11897,162,16,161,3,77,74,FALSE
11898,177,23,295,4,64,60,FALSE
11899,148,5,107,7,50,43,FALSE
11900,35,23,247,12,31,19,FALSE
11901,169,12,139,18,73,55,FALSE
11902,81,12,87,18,79,61,FALSE
11903,171,1,133,8,67,59,FALSE
11904,198,17,164,14,74,60,FALSE
11905,167,28,202,14,63,49,FALSE
11906,160,20,233,16,91,75,FALSE
11907,77,8,127,5,56,51,FALSE
11908,34,19,79,5,50,45,FALSE
11909,89,6,136,4,83,79,FALSE
11910,77,13,260,18,76,58,FALSE
11911,132,26,102,7,41,34,FALSE
11912,138,3,208,20,60,40,FALSE
11913,119,17,214,3,74,71,FALSE
11914,198,13,159,19,83,64,FALSE
11915,152,15,210,9,52,43,FALSE
11916,118,18,96,12,50,38,FALSE
11917,24,5,52,20,63,43,FALSE
11918,139,26,130,11,47,36,FALSE
11919,118,27,206,2,61,59,FALSE
11920,165,21,221,9,43,34,True
11921,115,19,106,6,53,47,FALSE
11922,84,17,49,19,46,27,FALSE
11923,183,6,101,18,100,82,FALSE
11924,125,17,165,20,42,22,FALSE
11925,87,6,75,20,43,23,FALSE
11926,120,4,228,8,76,68,FALSE
11927,54,22,227,17,100,83,FALSE
11928,50,16,151,4,70,66,FALSE
11929,46,3,238,10,87,77,FALSE
11930,84,22,87,12,22,10,FALSE
11931,90,1,215,11,96,85,FALSE
11932,128,10,162,16,86,70,FALSE
11933,64,18,246,19,60,41,FALSE
11934,41,16,138,11,89,78,FALSE
11935,92,14,89,5,28,23,FALSE
11936,77,5,275,20,82,62,FALSE
11937,200,1,64,20,49,29,FALSE
11938,196,20,41,7,58,51,FALSE
11939,160,4,221,14,61,47,FALSE
11940,127,21,217,20,59,39,FALSE
11941,31,12,244,1,72,71,FALSE
11942,95,28,160,5,85,80,FALSE
11943,47,6,79,1,79,78,FALSE
11944,103,11,186,8,90,82,FALSE
11945,105,27,297,13,34,21,FALSE
11946,145,23,215,18,50,32,True
11947,94,28,48,20,30,10,FALSE
11948,158,24,133,12,75,63,FALSE
11949,132,11,240,20,94,74,FALSE
11950,78,12,138,19,85,66,FALSE
11951,199,17,78,12,28,16,FALSE
11952,180,15,101,11,88,77,FALSE
11953,132,11,281,3,99,96,FALSE
11954,96,8,293,6,70,64,FALSE
11955,165,8,110,16,35,19,FALSE
11956,90,23,148,11,68,57,FALSE
11957,172,26,300,20,20,0,FALSE
11958,182,9,80,17,63,46,FALSE
11959,24,4,149,8,51,43,FALSE
11960,112,14,86,1,25,24,True
11961,115,30,274,15,49,34,FALSE
11962,161,26,32,8,35,27,FALSE
11963,64,29,174,15,97,82,FALSE
11964,200,29,200,2,54,52,FALSE
11965,103,4,61,12,50,38,FALSE
11966,52,10,246,2,78,76,FALSE
11967,140,10,77,17,92,75,FALSE
11968,71,30,146,15,53,38,FALSE
11969,163,16,166,4,62,58,FALSE
11970,62,18,217,10,44,34,FALSE
11971,119,6,273,3,41,38,FALSE
11972,69,8,279,3,93,90,FALSE
11973,146,17,222,1,94,93,FALSE
11974,135,28,138,19,82,63,FALSE
11975,127,21,69,2,95,93,FALSE
11976,108,15,30,12,90,78,FALSE
11977,166,11,284,8,25,17,FALSE
11978,184,28,132,2,21,19,FALSE
11979,179,12,126,17,67,50,FALSE
11980,68,21,22,15,59,44,FALSE
11981,95,20,153,19,98,79,FALSE
11982,129,24,124,7,86,79,FALSE
11983,126,1,65,10,67,57,FALSE
11984,36,18,131,17,26,9,FALSE
11985,184,17,151,10,43,33,FALSE
11986,40,14,200,13,26,13,FALSE
11987,45,9,53,1,64,63,FALSE
11988,163,16,256,1,65,64,FALSE
11989,77,13,26,19,90,71,FALSE
11990,105,30,197,1,29,28,FALSE
11991,73,18,281,6,33,27,FALSE
11992,144,29,234,7,62,55,FALSE
11993,131,9,147,19,95,76,FALSE
11994,185,27,286,6,92,86,FALSE
11995,86,22,270,9,92,83,FALSE
11996,37,12,25,3,62,59,FALSE
11997,43,1,235,19,81,62,FALSE
11998,111,30,297,10,68,58,FALSE
11999,25,12,37,13,21,8,FALSE
12000,160,27,164,2,89,87,FALSE
12001,118,17,122,1,71,70,FALSE
12002,64,27,219,10,88,78,FALSE
12003,31,20,285,2,72,70,FALSE
12004,57,12,89,15,69,54,True
12005,185,21,191,8,34,26,FALSE
12006,107,19,234,15,46,31,FALSE
12007,40,7,139,8,79,71,FALSE
12008,75,18,61,13,31,18,FALSE
12009,146,29,38,14,49,35,FALSE
12010,94,6,179,19,45,26,FALSE
12011,111,6,191,10,88,78,FALSE
12012,118,12,105,9,86,77,FALSE
12013,177,23,69,1,79,78,FALSE
12014,121,28,110,2,82,80,FALSE
12015,108,3,114,20,45,25,FALSE
12016,166,20,271,6,63,57,FALSE
12017,59,15,215,6,51,45,FALSE
12018,22,3,65,13,33,20,FALSE
12019,84,12,117,5,31,26,True
12020,135,27,67,8,46,38,FALSE
12021,74,5,143,9,82,73,FALSE
12022,33,29,258,11,54,43,FALSE
12023,113,2,205,8,70,62,FALSE
12024,115,24,118,13,91,78,FALSE
12025,162,18,205,9,20,11,FALSE
12026,129,30,133,20,61,41,FALSE
12027,55,24,28,14,33,19,FALSE
12028,47,25,89,6,37,31,FALSE
12029,136,6,40,5,100,95,FALSE
12030,56,14,69,12,30,18,FALSE
12031,46,21,127,5,32,27,FALSE
12032,82,16,183,6,44,38,FALSE
12033,72,8,192,11,84,73,FALSE
12034,130,16,180,13,28,15,FALSE
12035,157,12,227,5,49,44,FALSE
12036,98,29,260,14,53,39,FALSE
12037,142,8,257,2,45,43,FALSE
12038,124,6,185,5,97,92,FALSE
12039,21,23,137,4,23,19,FALSE
12040,102,9,187,7,67,60,FALSE
12041,99,22,168,1,23,22,FALSE
12042,78,11,273,2,62,60,FALSE
12043,199,6,116,4,87,83,FALSE
12044,86,19,136,9,34,25,FALSE
12045,77,14,270,9,58,49,True
12046,101,12,272,11,84,73,FALSE
12047,27,22,211,20,77,57,FALSE
12048,26,13,71,3,27,24,FALSE
12049,98,28,49,20,91,71,FALSE
12050,26,6,166,7,29,22,FALSE
12051,67,22,192,8,36,28,FALSE
12052,64,11,23,18,61,43,FALSE
12053,142,29,224,12,35,23,FALSE
12054,176,7,89,20,86,66,FALSE
12055,139,30,203,1,86,85,FALSE
12056,92,22,137,4,54,50,FALSE
12057,170,4,81,12,24,12,FALSE
12058,130,18,243,9,56,47,FALSE
12059,73,9,209,15,85,70,FALSE
12060,181,30,88,18,50,32,FALSE
12061,57,2,95,1,85,84,FALSE
12062,193,27,126,10,51,41,FALSE
12063,135,15,30,14,40,26,FALSE
12064,89,25,134,20,28,8,FALSE
12065,71,29,53,20,57,37,FALSE
12066,200,26,167,7,53,46,FALSE
12067,134,8,298,6,56,50,FALSE
12068,74,5,177,6,63,57,FALSE
12069,49,3,98,12,90,78,FALSE
12070,104,11,126,20,48,28,FALSE
12071,60,19,74,5,29,24,FALSE
12072,190,13,38,18,96,78,FALSE
12073,167,1,176,8,90,82,FALSE
12074,120,3,172,1,68,67,FALSE
12075,160,13,102,4,72,68,FALSE
12076,110,19,157,8,53,45,FALSE
12077,143,22,298,3,86,83,FALSE
12078,174,18,52,11,63,52,FALSE
12079,41,21,139,15,54,39,FALSE
12080,55,28,292,6,21,15,FALSE
12081,136,26,50,17,54,37,FALSE
12082,56,29,192,7,50,43,FALSE
12083,70,24,27,6,37,31,FALSE
12084,92,22,141,19,49,30,FALSE
12085,61,29,242,4,28,24,FALSE
12086,160,12,263,18,20,2,FALSE
12087,77,17,122,11,74,63,FALSE
12088,91,12,182,18,29,11,FALSE
12089,186,21,110,7,91,84,FALSE
12090,143,15,226,2,86,84,FALSE
12091,92,11,105,15,50,35,FALSE
12092,170,22,293,12,28,16,FALSE
12093,59,6,94,13,26,13,FALSE
12094,170,28,265,9,48,39,FALSE
12095,24,26,291,15,45,30,FALSE
12096,129,21,136,7,57,50,FALSE
12097,164,16,157,20,77,57,FALSE
12098,117,5,70,6,59,53,True
12099,43,24,135,18,95,77,FALSE
12100,35,2,261,17,47,30,FALSE
12101,197,8,295,10,67,57,FALSE
12102,141,5,249,8,30,22,FALSE
12103,37,10,280,13,45,32,FALSE
12104,24,9,287,5,84,79,FALSE
12105,141,12,55,8,49,41,FALSE
12106,118,19,289,9,69,60,FALSE
12107,146,1,117,16,31,15,FALSE
12108,127,27,39,2,84,82,FALSE
12109,108,2,231,3,32,29,FALSE
12110,26,15,141,12,36,24,FALSE
12111,142,23,156,19,92,73,FALSE
12112,56,24,106,15,32,17,FALSE
12113,115,13,168,17,66,49,FALSE
12114,141,13,155,20,41,21,FALSE
12115,180,13,297,8,45,37,FALSE
12116,123,25,213,19,29,10,FALSE
12117,108,3,122,18,41,23,FALSE
12118,64,30,239,1,58,57,FALSE
12119,30,29,276,7,33,26,FALSE
12120,142,17,20,12,33,21,FALSE
12121,163,28,284,11,41,30,FALSE
12122,186,6,190,13,62,49,FALSE
12123,144,23,237,16,37,21,FALSE
12124,163,13,150,7,51,44,FALSE
12125,179,13,276,15,90,75,FALSE
12126,58,18,270,17,60,43,FALSE
12127,184,12,79,14,64,50,FALSE
12128,149,6,119,2,41,39,FALSE
12129,38,2,71,19,66,47,FALSE
12130,109,1,127,1,80,79,FALSE
12131,60,2,50,2,95,93,FALSE
12132,169,23,87,20,46,26,FALSE
12133,122,16,86,12,42,30,FALSE
12134,21,29,240,4,83,79,FALSE
12135,82,21,241,17,95,78,FALSE
12136,54,22,113,3,72,69,FALSE
12137,159,11,255,8,21,13,FALSE
12138,55,22,60,19,47,28,FALSE
12139,188,14,246,6,79,73,FALSE
12140,83,19,219,15,44,29,FALSE
12141,34,3,71,12,41,29,FALSE
12142,126,13,44,10,83,73,FALSE
12143,125,2,44,2,95,93,FALSE
12144,165,28,265,3,57,54,FALSE
12145,23,11,107,9,83,74,FALSE
12146,24,2,241,7,95,88,FALSE
12147,89,11,89,10,91,81,FALSE
12148,93,16,61,9,70,61,FALSE
12149,151,2,194,4,66,62,FALSE
12150,42,30,228,17,23,6,FALSE
12151,36,4,166,12,97,85,True
12152,46,19,296,12,80,68,FALSE
12153,64,5,120,17,83,66,FALSE
12154,83,6,120,15,58,43,FALSE
12155,80,14,74,20,86,66,FALSE
12156,150,26,27,16,27,11,FALSE
12157,31,30,135,8,72,64,FALSE
12158,36,27,179,10,81,71,FALSE
12159,98,3,67,20,77,57,FALSE
12160,90,18,77,15,35,20,FALSE
12161,157,23,265,7,82,75,FALSE
12162,47,18,104,6,88,82,FALSE
12163,157,20,106,17,90,73,FALSE
12164,102,6,230,13,56,43,FALSE
12165,180,25,252,4,95,91,FALSE
12166,47,21,197,17,93,76,FALSE
12167,84,1,299,12,52,40,FALSE
12168,104,2,73,10,52,42,FALSE
12169,174,26,48,18,83,65,FALSE
12170,42,22,25,1,33,32,FALSE
12171,36,26,261,14,55,41,FALSE
12172,193,3,263,10,36,26,FALSE
12173,43,17,49,11,37,26,FALSE
12174,70,30,208,8,74,66,FALSE
12175,143,16,210,16,88,72,FALSE
12176,44,14,156,2,74,72,FALSE
12177,55,15,162,1,81,80,FALSE
12178,163,22,176,3,62,59,FALSE
12179,170,30,80,2,59,57,FALSE
12180,101,1,155,8,42,34,FALSE
12181,76,16,35,19,91,72,FALSE
12182,172,27,40,2,77,75,FALSE
12183,37,17,91,20,30,10,FALSE
12184,77,6,245,9,33,24,FALSE
12185,166,1,289,16,99,83,FALSE
12186,162,1,174,6,22,16,FALSE
12187,71,27,27,5,68,63,FALSE
12188,149,14,237,3,32,29,FALSE
12189,94,4,22,7,90,83,FALSE
12190,120,16,63,2,72,70,True
12191,194,17,55,14,75,61,FALSE
12192,100,2,111,7,23,16,FALSE
12193,43,4,32,3,70,67,True
12194,194,3,245,4,63,59,FALSE
12195,33,7,85,18,98,80,FALSE
12196,43,1,244,13,65,52,FALSE
12197,80,4,163,8,98,90,FALSE
12198,96,9,212,16,75,59,FALSE
12199,140,16,69,18,78,60,FALSE
12200,180,14,263,6,22,16,FALSE
12201,197,17,172,5,89,84,FALSE
12202,37,1,48,10,35,25,FALSE
12203,146,23,114,17,41,24,FALSE
12204,154,12,299,3,96,93,FALSE
12205,85,10,145,15,63,48,FALSE
12206,53,19,287,15,49,34,FALSE
12207,36,25,41,17,65,48,FALSE
12208,123,25,271,2,45,43,FALSE
12209,93,10,155,4,100,96,FALSE
12210,58,1,60,18,70,52,FALSE
12211,71,8,161,17,99,82,FALSE
12212,44,15,48,19,29,10,FALSE
12213,62,15,195,17,90,73,FALSE
12214,180,19,245,18,81,63,FALSE
12215,91,16,286,19,38,19,FALSE
12216,100,5,245,1,22,21,FALSE
12217,149,18,97,20,74,54,FALSE
12218,179,5,200,12,88,76,FALSE
12219,72,6,150,17,81,64,FALSE
12220,76,17,121,20,100,80,FALSE
12221,152,19,291,5,78,73,FALSE
12222,114,21,149,1,73,72,FALSE
12223,27,16,25,15,44,29,FALSE
12224,77,13,263,4,52,48,FALSE
12225,49,12,252,6,38,32,FALSE
12226,196,22,32,7,76,69,FALSE
12227,168,29,112,11,22,11,FALSE
12228,175,24,80,10,38,28,FALSE
12229,190,15,239,2,91,89,True
12230,177,20,25,17,65,48,FALSE
12231,149,9,283,3,24,21,FALSE
12232,70,17,241,17,56,39,FALSE
12233,41,17,205,10,70,60,FALSE
12234,157,24,142,14,65,51,FALSE
12235,168,29,216,18,77,59,FALSE
12236,38,16,284,14,31,17,FALSE
12237,120,23,252,10,67,57,FALSE
12238,31,29,287,18,61,43,FALSE
12239,166,13,258,20,31,11,FALSE
12240,161,5,246,20,97,77,FALSE
12241,145,12,135,16,64,48,FALSE
12242,74,19,154,5,98,93,FALSE
12243,70,2,223,2,89,87,FALSE
12244,21,24,256,3,38,35,FALSE
12245,184,3,54,11,43,32,FALSE
12246,102,4,34,18,24,6,FALSE
12247,77,10,140,18,64,46,FALSE
12248,188,25,226,17,90,73,FALSE
12249,41,24,89,15,70,55,FALSE
12250,113,11,172,3,84,81,FALSE
12251,56,20,31,6,64,58,FALSE
12252,30,2,294,9,41,32,FALSE
12253,125,4,222,12,32,20,FALSE
12254,154,13,174,10,95,85,FALSE
12255,118,15,150,12,63,51,FALSE
12256,153,2,135,3,54,51,FALSE
12257,92,2,49,14,92,78,FALSE
12258,105,26,117,6,69,63,FALSE
12259,35,13,203,9,54,45,FALSE
12260,84,14,180,6,79,73,FALSE
12261,159,9,268,1,24,23,FALSE
12262,124,12,148,6,40,34,FALSE
12263,179,5,215,13,77,64,FALSE
12264,70,8,141,4,80,76,FALSE
12265,194,13,227,13,94,81,FALSE
12266,131,22,228,9,36,27,FALSE
12267,197,22,93,16,68,52,FALSE
12268,142,15,176,18,97,79,FALSE
12269,158,13,123,8,35,27,FALSE
12270,198,22,97,12,37,25,FALSE
12271,108,24,294,6,60,54,FALSE
12272,29,30,65,1,74,73,FALSE
12273,94,6,295,8,29,21,True
12274,33,3,172,5,46,41,FALSE
12275,116,16,176,18,94,76,FALSE
12276,60,16,269,7,50,43,FALSE
12277,60,14,245,10,55,45,FALSE
12278,91,26,206,15,75,60,FALSE
12279,170,4,294,17,74,57,FALSE
12280,192,14,117,10,93,83,FALSE
12281,117,27,242,18,49,31,FALSE
12282,84,5,134,9,40,31,FALSE
12283,112,19,155,19,72,53,FALSE
12284,71,8,187,16,83,67,FALSE
12285,46,3,116,10,29,19,FALSE
12286,31,29,217,11,32,21,FALSE
12287,53,21,27,3,80,77,FALSE
12288,146,10,268,12,100,88,FALSE
12289,64,27,265,2,84,82,FALSE
12290,177,8,98,3,66,63,FALSE
12291,149,23,180,14,47,33,FALSE
12292,44,27,222,3,43,40,FALSE
12293,133,27,36,16,90,74,FALSE
12294,58,7,256,16,94,78,FALSE
12295,144,28,236,7,40,33,FALSE
12296,125,25,170,13,64,51,FALSE
12297,27,13,21,1,60,59,FALSE
12298,57,13,262,17,65,48,FALSE
12299,76,7,217,4,33,29,FALSE
12300,155,27,179,12,72,60,FALSE
12301,170,27,234,9,67,58,FALSE
12302,54,24,210,19,63,44,FALSE
12303,118,7,225,17,49,32,FALSE
12304,178,2,206,11,79,68,FALSE
12305,47,1,128,3,49,46,FALSE
12306,45,24,45,11,77,66,FALSE
12307,188,26,27,4,30,26,FALSE
12308,63,12,293,4,94,90,FALSE
12309,176,26,95,13,86,73,FALSE
12310,92,20,50,14,82,68,FALSE
12311,94,19,27,4,41,37,FALSE
12312,84,28,85,8,28,20,FALSE
12313,123,14,177,14,45,31,FALSE
12314,148,21,208,1,64,63,FALSE
12315,39,15,257,4,94,90,FALSE
12316,47,30,156,20,77,57,FALSE
12317,83,15,83,1,30,29,FALSE
12318,182,12,191,15,76,61,FALSE
12319,47,8,225,17,46,29,FALSE
12320,139,30,218,10,26,16,FALSE
12321,111,1,249,13,95,82,FALSE
12322,179,21,31,11,77,66,FALSE
12323,191,1,207,20,45,25,FALSE
12324,178,1,195,11,73,62,FALSE
12325,190,13,33,11,98,87,FALSE
12326,172,14,175,16,73,57,FALSE
12327,83,3,215,14,96,82,FALSE
12328,103,7,178,19,77,58,FALSE
12329,23,28,35,20,84,64,FALSE
12330,132,17,133,18,85,67,FALSE
12331,200,5,241,14,49,35,FALSE
12332,187,19,217,17,54,37,FALSE
12333,38,28,186,5,60,55,FALSE
12334,56,17,268,10,42,32,FALSE
12335,98,12,255,3,62,59,FALSE
12336,160,18,174,2,74,72,FALSE
12337,177,17,167,13,51,38,FALSE
12338,96,5,204,1,88,87,FALSE
12339,157,10,44,8,82,74,FALSE
12340,175,22,245,14,91,77,FALSE
12341,170,7,188,15,34,19,FALSE
12342,96,30,191,16,67,51,FALSE
12343,55,11,55,20,28,8,FALSE
12344,162,20,275,2,57,55,FALSE
12345,174,11,299,5,33,28,FALSE
12346,129,20,117,20,84,64,FALSE
12347,84,30,262,6,44,38,FALSE
12348,190,29,281,14,24,10,FALSE
12349,59,12,29,10,20,10,FALSE
12350,199,23,248,1,24,23,FALSE
12351,32,23,256,6,66,60,FALSE
12352,194,29,75,20,44,24,FALSE
12353,43,14,70,11,40,29,FALSE
12354,184,27,32,16,98,82,FALSE
12355,60,22,285,8,97,89,FALSE
12356,23,23,135,3,83,80,FALSE
12357,20,24,261,13,95,82,FALSE
12358,200,25,90,3,39,36,FALSE
12359,112,10,255,2,52,50,FALSE
12360,115,20,139,1,40,39,FALSE
12361,73,4,158,15,94,79,FALSE
12362,50,21,209,6,36,30,FALSE
12363,180,22,124,1,53,52,FALSE
12364,31,28,37,13,58,45,FALSE
12365,100,22,271,18,67,49,FALSE
12366,61,12,214,15,21,6,FALSE
12367,65,18,262,11,42,31,FALSE
12368,87,16,197,7,55,48,FALSE
12369,69,28,159,6,71,65,FALSE
12370,58,6,230,13,82,69,FALSE
12371,48,13,128,14,84,70,FALSE
12372,91,8,229,13,55,42,FALSE
12373,69,24,223,13,68,55,FALSE
12374,91,8,168,16,88,72,True
12375,79,2,63,1,48,47,FALSE
12376,33,26,68,5,63,58,FALSE
12377,69,4,189,20,59,39,FALSE
12378,46,23,181,10,83,73,True
12379,82,24,177,8,20,12,FALSE
12380,132,13,88,7,45,38,FALSE
12381,110,3,266,7,93,86,FALSE
12382,94,2,139,13,57,44,FALSE
12383,56,24,268,10,79,69,FALSE
12384,126,14,85,9,87,78,FALSE
12385,66,18,258,14,31,17,FALSE
12386,147,16,239,8,60,52,FALSE
12387,77,23,84,18,100,82,FALSE
12388,137,20,207,14,92,78,FALSE
12389,78,1,234,16,22,6,FALSE
12390,194,9,277,16,21,5,FALSE
12391,65,22,75,19,57,38,FALSE
12392,155,14,143,20,61,41,FALSE
12393,172,1,261,14,88,74,FALSE
12394,90,7,256,2,75,73,FALSE
12395,101,21,194,17,72,55,FALSE
12396,95,16,227,14,48,34,FALSE
12397,101,21,295,7,28,21,FALSE
12398,158,19,92,12,51,39,FALSE
12399,116,2,259,5,33,28,FALSE
12400,148,9,180,7,96,89,FALSE
12401,109,1,109,11,89,78,FALSE
12402,101,2,125,5,89,84,FALSE
12403,175,14,119,8,59,51,FALSE
12404,57,8,232,4,56,52,FALSE
12405,113,3,37,19,25,6,True
12406,41,14,23,19,49,30,FALSE
12407,135,5,232,15,28,13,FALSE
12408,179,1,208,5,42,37,FALSE
12409,92,18,158,11,66,55,FALSE
12410,35,1,135,12,45,33,FALSE
12411,102,5,56,16,20,4,FALSE
12412,130,30,26,18,56,38,FALSE
12413,114,10,239,18,69,51,FALSE
12414,163,24,37,5,87,82,FALSE
12415,179,3,275,6,52,46,FALSE
12416,28,4,58,18,58,40,FALSE
12417,106,5,217,17,27,10,FALSE
12418,70,17,283,11,35,24,True
12419,141,13,262,18,56,38,FALSE
12420,123,15,25,11,81,70,FALSE
12421,87,26,172,6,49,43,FALSE
12422,87,15,42,20,34,14,FALSE
12423,80,28,161,19,55,36,FALSE
12424,147,5,177,1,62,61,FALSE
12425,72,21,242,13,97,84,FALSE
12426,60,12,121,15,82,67,FALSE
12427,186,28,167,9,66,57,FALSE
12428,36,4,215,8,60,52,FALSE
12429,192,7,159,19,76,57,FALSE
12430,105,12,219,11,67,56,FALSE
12431,80,14,87,20,97,77,FALSE
12432,171,22,133,16,78,62,FALSE
12433,194,1,271,18,57,39,FALSE
12434,66,7,225,3,96,93,FALSE
12435,49,4,152,17,44,27,FALSE
12436,91,19,183,18,53,35,FALSE
12437,88,29,130,18,30,12,FALSE
12438,106,28,267,8,87,79,FALSE
12439,103,28,42,12,35,23,FALSE
12440,126,17,235,3,23,20,FALSE
12441,63,19,68,13,66,53,FALSE
12442,144,25,264,9,73,64,FALSE
12443,42,8,29,9,73,64,FALSE
12444,170,21,195,1,26,25,FALSE
12445,75,21,119,16,100,84,FALSE
12446,172,22,34,14,89,75,FALSE
12447,56,15,24,20,24,4,FALSE
12448,132,19,257,16,21,5,FALSE
12449,81,14,84,5,66,61,FALSE
12450,28,30,225,4,56,52,FALSE
12451,198,28,194,17,41,24,FALSE
12452,144,3,282,18,32,14,FALSE
12453,103,15,22,9,33,24,FALSE
12454,198,5,124,13,37,24,FALSE
12455,151,22,174,9,55,46,FALSE
12456,39,24,250,5,83,78,FALSE
12457,62,20,136,13,83,70,FALSE
12458,113,25,197,3,72,69,FALSE
12459,145,2,193,20,34,14,FALSE
12460,139,8,267,4,26,22,FALSE
12461,158,26,231,7,76,69,FALSE
12462,71,5,285,10,35,25,FALSE
12463,116,23,295,15,90,75,FALSE
12464,133,1,107,4,99,95,FALSE
12465,119,4,87,15,24,9,FALSE
12466,143,18,79,11,85,74,FALSE
12467,46,20,258,1,22,21,FALSE
12468,165,24,69,12,68,56,True
12469,150,6,20,11,87,76,FALSE
12470,179,21,229,6,97,91,FALSE
12471,169,10,220,15,34,19,FALSE
12472,97,22,191,12,91,79,FALSE
12473,47,10,179,12,89,77,FALSE
12474,164,21,83,12,43,31,FALSE
12475,178,3,125,11,78,67,FALSE
12476,23,16,281,14,98,84,FALSE
12477,190,15,228,4,89,85,FALSE
12478,36,19,269,14,57,43,True
12479,195,18,54,4,99,95,FALSE
12480,163,14,105,10,90,80,FALSE
12481,46,19,117,15,40,25,FALSE
12482,59,14,170,6,44,38,FALSE
12483,34,25,269,11,95,84,FALSE
12484,125,21,239,13,74,61,FALSE
12485,189,21,232,5,50,45,FALSE
12486,155,26,92,14,71,57,FALSE
12487,82,21,237,5,24,19,FALSE
12488,119,15,39,17,25,8,FALSE
12489,174,20,29,16,96,80,FALSE
12490,148,4,282,10,68,58,FALSE
12491,21,9,292,18,59,41,FALSE
12492,46,6,189,6,27,21,FALSE
12493,137,21,98,10,49,39,FALSE
12494,166,5,222,8,30,22,FALSE
12495,91,10,291,15,20,5,True
12496,173,11,207,3,82,79,FALSE
12497,196,20,290,13,38,25,FALSE
12498,160,30,198,7,84,77,FALSE
12499,45,29,22,4,33,29,FALSE
12500,62,4,130,18,54,36,FALSE
12501,64,4,29,3,20,17,FALSE
12502,185,21,139,1,83,82,FALSE
12503,162,18,272,17,76,59,FALSE
12504,176,1,155,19,28,9,FALSE
12505,33,9,111,13,71,58,FALSE
12506,56,24,173,14,95,81,FALSE
12507,135,12,163,16,57,41,FALSE
12508,65,26,112,15,73,58,FALSE
12509,53,21,249,14,93,79,FALSE
12510,176,19,278,18,55,37,FALSE
12511,180,11,297,4,46,42,FALSE
12512,195,24,57,13,91,78,FALSE
12513,193,14,167,2,55,53,FALSE
12514,107,19,224,20,75,55,FALSE
12515,199,29,45,8,67,59,FALSE
12516,93,8,56,6,75,69,FALSE
12517,131,2,61,16,60,44,FALSE
12518,44,3,35,6,93,87,FALSE
12519,30,11,45,9,45,36,FALSE
12520,117,12,281,9,73,64,FALSE
12521,149,18,24,10,55,45,FALSE
12522,169,24,183,11,67,56,FALSE
12523,174,21,143,7,54,47,FALSE
12524,44,7,62,4,72,68,FALSE
12525,124,25,204,1,72,71,FALSE
12526,186,9,291,16,22,6,FALSE
12527,96,6,199,17,31,14,FALSE
12528,113,13,104,9,64,55,FALSE
12529,104,9,292,14,72,58,FALSE
12530,171,25,220,5,86,81,FALSE
12531,105,4,287,14,63,49,FALSE
12532,193,10,277,19,24,5,FALSE
12533,118,16,62,12,68,56,FALSE
12534,75,14,179,13,41,28,FALSE
12535,35,26,298,2,95,93,FALSE
12536,65,14,131,4,27,23,FALSE
12537,197,10,114,19,84,65,FALSE
12538,56,9,160,6,79,73,FALSE
12539,65,5,275,9,36,27,FALSE
12540,155,14,296,13,58,45,FALSE
12541,81,5,195,2,21,19,FALSE
12542,120,19,106,18,49,31,FALSE
12543,199,3,155,18,57,39,FALSE
12544,90,1,161,10,59,49,FALSE
12545,176,4,52,18,76,58,FALSE
